rundate,this_period,foreign_region,foreign_country,UK_airport,foreign_airport,total_pax_this_period,total_pax_scheduled_this_period,total_pax_charter_this_period,total_pax_last_period,total_pax_scheduled_last_period,total_pax_charter_last_period,total_pax_percent
11/03/2020 11:02,202001,Unknown,Unknown,BELFAST CITY (GEORGE BEST),Unknown,30,30,0,0,0,0,0
11/03/2020 11:02,202001,Unknown,Unknown,MANCHESTER,Unknown,743,0,743,0,0,0,0
11/03/2020 11:02,202001,WESTERN EUROPE-EU,AUSTRIA,GATWICK,INNSBRUCK,32763,27707,5056,34308,29763,4545,-4.503323
11/03/2020 11:02,202001,WESTERN EUROPE-EU,AUSTRIA,GATWICK,KLAGENFURT,1858,1858,0,2097,2097,0,-11.397234
11/03/2020 11:02,202001,WESTERN EUROPE-EU,AUSTRIA,GATWICK,LINZ,0,0,0,520,0,520,-100
11/03/2020 11:02,202001,WESTERN EUROPE-EU,AUSTRIA,GATWICK,SALZBURG,19177,16749,2428,18862,15383,3479,1.670024
11/03/2020 11:02,202001,WESTERN EUROPE-EU,AUSTRIA,GATWICK,VIENNA,11942,11942,0,18952,18952,0,-36.988181
11/03/2020 11:02,202001,WESTERN EUROPE-EU,AUSTRIA,HEATHROW,INNSBRUCK,5519,5519,0,7517,7517,0,-26.579753
11/03/2020 11:02,202001,WESTERN EUROPE-EU,AUSTRIA,HEATHROW,SALZBURG,4534,4534,0,3752,3752,0,20.842217
11/03/2020 11:02,202001,WESTERN EUROPE-EU,AUSTRIA,HEATHROW,VIENNA,56910,56910,0,48681,48681,0,16.903926
11/03/2020 11:02,202001,WESTERN EUROPE-EU,AUSTRIA,LUTON,INNSBRUCK,3778,3778,0,2163,2163,0,74.664817
11/03/2020 11:02,202001,WESTERN EUROPE-EU,AUSTRIA,LUTON,LINZ,0,0,0,242,0,242,-100
11/03/2020 11:02,202001,WESTERN EUROPE-EU,AUSTRIA,LUTON,SALZBURG,2642,1732,910,2280,1646,634,15.877193
11/03/2020 11:02,202001,WESTERN EUROPE-EU,AUSTRIA,LUTON,VIENNA,3659,3659,0,3141,3141,0,16.491563
11/03/2020 11:02,202001,WESTERN EUROPE-EU,AUSTRIA,STANSTED,INNSBRUCK,2333,0,2333,2535,1018,1517,-7.968442
11/03/2020 11:02,202001,WESTERN EUROPE-EU,AUSTRIA,STANSTED,LINZ,0,0,0,238,0,238,-100
11/03/2020 11:02,202001,WESTERN EUROPE-EU,AUSTRIA,STANSTED,SALZBURG,10260,9267,993,11361,10538,823,-9.691048
11/03/2020 11:02,202001,WESTERN EUROPE-EU,AUSTRIA,STANSTED,VIENNA,17087,17087,0,18574,18574,0,-8.005815
11/03/2020 11:02,202001,WESTERN EUROPE-EU,AUSTRIA,BELFAST CITY (GEORGE BEST),SALZBURG,0,0,0,690,0,690,-100
11/03/2020 11:02,202001,WESTERN EUROPE-EU,AUSTRIA,BELFAST INTERNATIONAL,SALZBURG,2669,1974,695,2735,1757,978,-2.413163
11/03/2020 11:02,202001,WESTERN EUROPE-EU,AUSTRIA,BIRMINGHAM,INNSBRUCK,3980,994,2986,2948,0,2948,35.006784
11/03/2020 11:02,202001,WESTERN EUROPE-EU,AUSTRIA,BIRMINGHAM,LINZ,0,0,0,382,0,382,-100
11/03/2020 11:02,202001,WESTERN EUROPE-EU,AUSTRIA,BIRMINGHAM,SALZBURG,2529,1252,1277,2465,1337,1128,2.596349
11/03/2020 11:02,202001,WESTERN EUROPE-EU,AUSTRIA,BIRMINGHAM,VIENNA,6556,6556,0,1710,1710,0,283.391813
11/03/2020 11:02,202001,WESTERN EUROPE-EU,AUSTRIA,BRISTOL,INNSBRUCK,5398,3105,2293,4657,2198,2459,15.911531
11/03/2020 11:02,202001,WESTERN EUROPE-EU,AUSTRIA,BRISTOL,LINZ,148,0,148,0,0,0,0
11/03/2020 11:02,202001,WESTERN EUROPE-EU,AUSTRIA,BRISTOL,SALZBURG,3832,2479,1353,4170,2580,1590,-8.105516
11/03/2020 11:02,202001,WESTERN EUROPE-EU,AUSTRIA,BRISTOL,VIENNA,2638,2638,0,2516,2516,0,4.848967
11/03/2020 11:02,202001,WESTERN EUROPE-EU,AUSTRIA,EAST MIDLANDS INTERNATIONAL,SALZBURG,2046,1095,951,1972,862,1110,3.752535
11/03/2020 11:02,202001,WESTERN EUROPE-EU,AUSTRIA,EDINBURGH,INNSBRUCK,2591,0,2591,2313,0,2313,12.019023
11/03/2020 11:02,202001,WESTERN EUROPE-EU,AUSTRIA,EDINBURGH,SALZBURG,2152,1406,746,1952,1233,719,10.245902
11/03/2020 11:02,202001,WESTERN EUROPE-EU,AUSTRIA,EDINBURGH,VIENNA,6008,6008,0,3191,3191,0,88.279536
11/03/2020 11:02,202001,WESTERN EUROPE-EU,AUSTRIA,GLASGOW,LINZ,0,0,0,379,0,379,-100
11/03/2020 11:02,202001,WESTERN EUROPE-EU,AUSTRIA,GLASGOW,SALZBURG,0,0,0,821,0,821,-100
11/03/2020 11:02,202001,WESTERN EUROPE-EU,AUSTRIA,LEEDS BRADFORD,SALZBURG,1084,1084,0,1088,1088,0,-0.367647
11/03/2020 11:02,202001,WESTERN EUROPE-EU,AUSTRIA,LEEDS BRADFORD,VIENNA,157,157,0,0,0,0,0
11/03/2020 11:02,202001,WESTERN EUROPE-EU,AUSTRIA,LIVERPOOL (JOHN LENNON),SALZBURG,1109,1109,0,1111,1111,0,-0.180018
11/03/2020 11:02,202001,WESTERN EUROPE-EU,AUSTRIA,LIVERPOOL (JOHN LENNON),VIENNA,2613,2613,0,0,0,0,0
11/03/2020 11:02,202001,WESTERN EUROPE-EU,AUSTRIA,MANCHESTER,INNSBRUCK,8295,2956,5339,8152,4089,4063,1.754171
11/03/2020 11:02,202001,WESTERN EUROPE-EU,AUSTRIA,MANCHESTER,SALZBURG,4899,3224,1675,6345,3076,3269,-22.789598
11/03/2020 11:02,202001,WESTERN EUROPE-EU,AUSTRIA,MANCHESTER,VIENNA,5792,5792,0,6405,6405,0,-9.570648
11/03/2020 11:02,202001,WESTERN EUROPE-EU,AUSTRIA,NEWCASTLE,INNSBRUCK,1463,1463,0,1322,1322,0,10.665658
11/03/2020 11:02,202001,WESTERN EUROPE-EU,AUSTRIA,NEWCASTLE,SALZBURG,1187,1187,0,1134,1134,0,4.673721
11/03/2020 11:02,202001,WESTERN EUROPE-EU,BELGIUM,GATWICK,BRUSSELS,0,0,0,2182,2182,0,-100
11/03/2020 11:02,202001,WESTERN EUROPE-EU,BELGIUM,HEATHROW,BRUSSELS,49081,49081,0,49918,49918,0,-1.67675
11/03/2020 11:02,202001,WESTERN EUROPE-EU,BELGIUM,LONDON CITY,ANTWERP,3254,3254,0,0,0,0,0
11/03/2020 11:02,202001,WESTERN EUROPE-EU,BELGIUM,LONDON CITY,BRUSSELS,26,26,0,0,0,0,0
11/03/2020 11:02,202001,WESTERN EUROPE-EU,BELGIUM,SOUTHEND,ANTWERP,0,0,0,533,533,0,-100
11/03/2020 11:02,202001,WESTERN EUROPE-EU,BELGIUM,ABERDEEN,BRUSSELS,368,368,0,0,0,0,0
11/03/2020 11:02,202001,WESTERN EUROPE-EU,BELGIUM,BIRMINGHAM,BRUSSELS,11859,11859,0,10824,10824,0,9.562084
11/03/2020 11:02,202001,WESTERN EUROPE-EU,BELGIUM,BRISTOL,BRUSSELS,4504,4504,0,3798,3798,0,18.588731
11/03/2020 11:02,202001,WESTERN EUROPE-EU,BELGIUM,EAST MIDLANDS INTERNATIONAL,BRUSSELS,23,23,0,2140,2140,0,-98.925234
11/03/2020 11:02,202001,WESTERN EUROPE-EU,BELGIUM,EDINBURGH,BRUSSELS,8533,8533,0,8043,8043,0,6.092254
11/03/2020 11:02,202001,WESTERN EUROPE-EU,BELGIUM,EDINBURGH,CHARLEROI,7004,7004,0,5113,5113,0,36.984158
11/03/2020 11:02,202001,WESTERN EUROPE-EU,BELGIUM,LEEDS BRADFORD,CHARLEROI,0,0,0,144,144,0,-100
11/03/2020 11:02,202001,WESTERN EUROPE-EU,BELGIUM,MANCHESTER,BRUSSELS,19318,19318,0,18088,18088,0,6.800088
11/03/2020 11:02,202001,WESTERN EUROPE-EU,BELGIUM,MANCHESTER,CHARLEROI,13130,13130,0,11590,11590,0,13.287317
11/03/2020 11:02,202001,WESTERN EUROPE-EU,BELGIUM,NEWCASTLE,BRUSSELS,1034,1034,0,2365,2365,0,-56.27907
11/03/2020 11:02,202001,WESTERN EUROPE-EU,CROATIA,GATWICK,DUBROVNIK,1329,1329,0,611,611,0,117.512275
11/03/2020 11:02,202001,WESTERN EUROPE-EU,CROATIA,HEATHROW,ZAGREB,10101,10101,0,9322,9322,0,8.356576
11/03/2020 11:02,202001,WESTERN EUROPE-EU,CYPRUS,GATWICK,LARNACA,6757,6757,0,6779,6779,0,-0.324532
11/03/2020 11:02,202001,WESTERN EUROPE-EU,CYPRUS,GATWICK,PAPHOS,8499,6033,2466,7529,5431,2098,12.883517
11/03/2020 11:02,202001,WESTERN EUROPE-EU,CYPRUS,HEATHROW,LARNACA,13526,13526,0,10471,10471,0,29.175819
11/03/2020 11:02,202001,WESTERN EUROPE-EU,CYPRUS,LUTON,LARNACA,11728,11728,0,11225,11225,0,4.481069
11/03/2020 11:02,202001,WESTERN EUROPE-EU,CYPRUS,LUTON,PAPHOS,3783,3783,0,4384,3572,812,-13.708942
11/03/2020 11:02,202001,WESTERN EUROPE-EU,CYPRUS,STANSTED,LARNACA,742,742,0,731,731,0,1.504788
11/03/2020 11:02,202001,WESTERN EUROPE-EU,CYPRUS,STANSTED,PAPHOS,12914,12914,0,11865,11680,185,8.841129
11/03/2020 11:02,202001,WESTERN EUROPE-EU,CYPRUS,BIRMINGHAM,LARNACA,0,0,0,3508,3508,0,-100
11/03/2020 11:02,202001,WESTERN EUROPE-EU,CYPRUS,BIRMINGHAM,PAPHOS,3794,3183,611,2696,1182,1514,40.727003
11/03/2020 11:02,202001,WESTERN EUROPE-EU,CYPRUS,BOURNEMOUTH,PAPHOS,186,0,186,1605,1605,0,-88.411215
11/03/2020 11:02,202001,WESTERN EUROPE-EU,CYPRUS,BRISTOL,LARNACA,2668,2668,0,2436,2436,0,9.52381
11/03/2020 11:02,202001,WESTERN EUROPE-EU,CYPRUS,BRISTOL,PAPHOS,4212,4027,185,3007,3007,0,40.073163
11/03/2020 11:02,202001,WESTERN EUROPE-EU,CYPRUS,CARDIFF WALES,PAPHOS,181,0,181,0,0,0,0
11/03/2020 11:02,202001,WESTERN EUROPE-EU,CYPRUS,DONCASTER SHEFFIELD,PAPHOS,194,0,194,0,0,0,0
11/03/2020 11:02,202001,WESTERN EUROPE-EU,CYPRUS,EAST MIDLANDS INTERNATIONAL,PAPHOS,178,0,178,0,0,0,0
11/03/2020 11:02,202001,WESTERN EUROPE-EU,CYPRUS,EDINBURGH,PAPHOS,3146,2956,190,3068,3068,0,2.542373
11/03/2020 11:02,202001,WESTERN EUROPE-EU,CYPRUS,LIVERPOOL (JOHN LENNON),LARNACA,963,963,0,2784,2784,0,-65.409483
11/03/2020 11:02,202001,WESTERN EUROPE-EU,CYPRUS,LIVERPOOL (JOHN LENNON),PAPHOS,1049,1049,0,2097,2097,0,-49.976156
11/03/2020 11:02,202001,WESTERN EUROPE-EU,CYPRUS,MANCHESTER,PAPHOS,12561,9798,2763,10979,8343,2636,14.409327
11/03/2020 11:02,202001,WESTERN EUROPE-EU,CYPRUS,NEWCASTLE,PAPHOS,1794,1794,0,1723,1723,0,4.12072
11/03/2020 11:02,202001,WESTERN EUROPE-EU,DENMARK,GATWICK,AARHUS (TIRSTRUP),1561,1561,0,1132,1132,0,37.897527
11/03/2020 11:02,202001,WESTERN EUROPE-EU,DENMARK,GATWICK,COPENHAGEN,52123,52123,0,55667,55667,0,-6.366429
11/03/2020 11:02,202001,WESTERN EUROPE-EU,DENMARK,HEATHROW,BILLUND,6723,6723,0,6923,6923,0,-2.888921
11/03/2020 11:02,202001,WESTERN EUROPE-EU,DENMARK,HEATHROW,COPENHAGEN,61661,61661,0,67235,67235,0,-8.290325
11/03/2020 11:02,202001,WESTERN EUROPE-EU,DENMARK,LONDON CITY,BILLUND,1760,1760,0,1710,1710,0,2.923977
11/03/2020 11:02,202001,WESTERN EUROPE-EU,DENMARK,LUTON,COPENHAGEN,8916,8916,0,9797,9797,0,-8.992549
11/03/2020 11:02,202001,WESTERN EUROPE-EU,DENMARK,SOUTHEND,KARUP,0,0,0,125,0,125,-100
11/03/2020 11:02,202001,WESTERN EUROPE-EU,DENMARK,STANSTED,AALBORG,3085,3085,0,4418,4418,0,-30.172024
11/03/2020 11:02,202001,WESTERN EUROPE-EU,DENMARK,STANSTED,AARHUS (TIRSTRUP),6359,6359,0,6098,6098,0,4.280092
11/03/2020 11:02,202001,WESTERN EUROPE-EU,DENMARK,STANSTED,BILLUND,15532,15532,0,16256,16256,0,-4.45374
11/03/2020 11:02,202001,WESTERN EUROPE-EU,DENMARK,STANSTED,COPENHAGEN,29165,29165,0,24355,24355,0,19.749538
11/03/2020 11:02,202001,WESTERN EUROPE-EU,DENMARK,ABERDEEN,COPENHAGEN,1229,1229,0,1508,1508,0,-18.501326
11/03/2020 11:02,202001,WESTERN EUROPE-EU,DENMARK,ABERDEEN,ESBJERG,960,960,0,728,728,0,31.868132
11/03/2020 11:02,202001,WESTERN EUROPE-EU,DENMARK,BIRMINGHAM,COPENHAGEN,5429,5429,0,4621,4621,0,17.485393
11/03/2020 11:02,202001,WESTERN EUROPE-EU,DENMARK,BRISTOL,COPENHAGEN,3229,3229,0,2781,2781,0,16.109313
11/03/2020 11:02,202001,WESTERN EUROPE-EU,DENMARK,EDINBURGH,COPENHAGEN,10659,10659,0,12229,12229,0,-12.838335
11/03/2020 11:02,202001,WESTERN EUROPE-EU,DENMARK,LEEDS BRADFORD,BILLUND,0,0,0,26,26,0,-100
11/03/2020 11:02,202001,WESTERN EUROPE-EU,DENMARK,LIVERPOOL (JOHN LENNON),COPENHAGEN,2511,2511,0,180,0,180,1295
11/03/2020 11:02,202001,WESTERN EUROPE-EU,DENMARK,MANCHESTER,AARHUS (TIRSTRUP),229,229,0,0,0,0,0
11/03/2020 11:02,202001,WESTERN EUROPE-EU,DENMARK,MANCHESTER,BILLUND,3945,3945,0,1791,1791,0,120.268007
11/03/2020 11:02,202001,WESTERN EUROPE-EU,DENMARK,MANCHESTER,COPENHAGEN,20128,20128,0,21316,21316,0,-5.573278
11/03/2020 11:02,202001,WESTERN EUROPE-EU,FINLAND,GATWICK,ENONTEKIO,262,0,262,631,0,631,-58.478605
11/03/2020 11:02,202001,WESTERN EUROPE-EU,FINLAND,GATWICK,HELSINKI,15826,15826,0,18644,18644,0,-15.114782
11/03/2020 11:02,202001,WESTERN EUROPE-EU,FINLAND,GATWICK,IVALO,1616,1616,0,1749,1569,180,-7.604345
11/03/2020 11:02,202001,WESTERN EUROPE-EU,FINLAND,GATWICK,KITTILA,2814,576,2238,2586,521,2065,8.816705
11/03/2020 11:02,202001,WESTERN EUROPE-EU,FINLAND,GATWICK,KUUSAMO,1236,0,1236,1264,0,1264,-2.21519
11/03/2020 11:02,202001,WESTERN EUROPE-EU,FINLAND,GATWICK,ROVANIEMI,7221,7066,155,6059,5848,211,19.178082
11/03/2020 11:02,202001,WESTERN EUROPE-EU,FINLAND,HEATHROW,HELSINKI,60473,60473,0,55115,55115,0,9.721491
11/03/2020 11:02,202001,WESTERN EUROPE-EU,FINLAND,BIRMINGHAM,ENONTEKIO,220,0,220,175,0,175,25.714286
11/03/2020 11:02,202001,WESTERN EUROPE-EU,FINLAND,BIRMINGHAM,KUUSAMO,1237,0,1237,975,0,975,26.871795
11/03/2020 11:02,202001,WESTERN EUROPE-EU,FINLAND,BOURNEMOUTH,ENONTEKIO,91,0,91,50,0,50,82
11/03/2020 11:02,202001,WESTERN EUROPE-EU,FINLAND,BRISTOL,KITTILA,1294,0,1294,1043,0,1043,24.065197
11/03/2020 11:02,202001,WESTERN EUROPE-EU,FINLAND,EAST MIDLANDS INTERNATIONAL,ENONTEKIO,163,0,163,0,0,0,0
11/03/2020 11:02,202001,WESTERN EUROPE-EU,FINLAND,EDINBURGH,HELSINKI,1792,1792,0,1132,1132,0,58.303887
11/03/2020 11:02,202001,WESTERN EUROPE-EU,FINLAND,EXETER,ENONTEKIO,0,0,0,85,0,85,-100
11/03/2020 11:02,202001,WESTERN EUROPE-EU,FINLAND,LEEDS BRADFORD,ENONTEKIO,116,0,116,354,0,354,-67.231638
11/03/2020 11:02,202001,WESTERN EUROPE-EU,FINLAND,MANCHESTER,ENONTEKIO,235,117,118,316,0,316,-25.632911
11/03/2020 11:02,202001,WESTERN EUROPE-EU,FINLAND,MANCHESTER,HELSINKI,13650,13650,0,11875,11875,0,14.947368
11/03/2020 11:02,202001,WESTERN EUROPE-EU,FINLAND,MANCHESTER,IVALO,0,0,0,160,0,160,-100
11/03/2020 11:02,202001,WESTERN EUROPE-EU,FINLAND,MANCHESTER,KITTILA,1852,0,1852,1770,0,1770,4.632768
11/03/2020 11:02,202001,WESTERN EUROPE-EU,FINLAND,MANCHESTER,KUUSAMO,1261,0,1261,1222,0,1222,3.191489
11/03/2020 11:02,202001,WESTERN EUROPE-EU,FINLAND,MANCHESTER,ROVANIEMI,517,517,0,0,0,0,0
11/03/2020 11:02,202001,WESTERN EUROPE-EU,FINLAND,NEWCASTLE,ENONTEKIO,174,174,0,0,0,0,0
11/03/2020 11:02,202001,WESTERN EUROPE-EU,FRANCE,GATWICK,BORDEAUX,13583,13583,0,15481,15481,0,-12.26019
11/03/2020 11:02,202001,WESTERN EUROPE-EU,FRANCE,GATWICK,CHAMBERY,10333,0,10333,10697,0,10697,-3.402823
11/03/2020 11:02,202001,WESTERN EUROPE-EU,FRANCE,GATWICK,GRENOBLE,18762,6145,12617,22678,8467,14211,-17.267837
11/03/2020 11:02,202001,WESTERN EUROPE-EU,FRANCE,GATWICK,LYON,24461,18709,5752,23445,19961,3484,4.333547
11/03/2020 11:02,202001,WESTERN EUROPE-EU,FRANCE,GATWICK,MARSEILLE,8420,8420,0,6428,6428,0,30.989421
11/03/2020 11:02,202001,WESTERN EUROPE-EU,FRANCE,GATWICK,MONTPELLIER,7388,7388,0,6763,6763,0,9.241461
11/03/2020 11:02,202001,WESTERN EUROPE-EU,FRANCE,GATWICK,NANTES,11022,11022,0,10831,10831,0,1.763457
11/03/2020 11:02,202001,WESTERN EUROPE-EU,FRANCE,GATWICK,NICE,25468,25468,0,27452,27452,0,-7.22716
11/03/2020 11:02,202001,WESTERN EUROPE-EU,FRANCE,GATWICK,PARIS (CHARLES DE GAULLE),48352,48352,0,38993,38993,0,24.001744
11/03/2020 11:02,202001,WESTERN EUROPE-EU,FRANCE,GATWICK,TOULOUSE (BLAGNAC),17186,14318,2868,15959,14584,1375,7.688452
11/03/2020 11:02,202001,WESTERN EUROPE-EU,FRANCE,HEATHROW,GRENOBLE,1094,1094,0,898,898,0,21.826281
11/03/2020 11:02,202001,WESTERN EUROPE-EU,FRANCE,HEATHROW,LYON,22638,22638,0,19188,19188,0,17.979987
11/03/2020 11:02,202001,WESTERN EUROPE-EU,FRANCE,HEATHROW,MARSEILLE,17514,17514,0,14966,14966,0,17.025257
11/03/2020 11:02,202001,WESTERN EUROPE-EU,FRANCE,HEATHROW,NICE,29379,29379,0,25444,25444,0,15.465336
11/03/2020 11:02,202001,WESTERN EUROPE-EU,FRANCE,HEATHROW,PARIS (CHARLES DE GAULLE),104976,104976,0,94574,94574,0,10.998795
11/03/2020 11:02,202001,WESTERN EUROPE-EU,FRANCE,HEATHROW,TOULOUSE (BLAGNAC),20037,20037,0,19114,19114,0,4.828921
11/03/2020 11:02,202001,WESTERN EUROPE-EU,FRANCE,LONDON CITY,CHAMBERY,934,934,0,1049,1049,0,-10.962822
11/03/2020 11:02,202001,WESTERN EUROPE-EU,FRANCE,LONDON CITY,GRENOBLE,26,26,0,0,0,0,0
11/03/2020 11:02,202001,WESTERN EUROPE-EU,FRANCE,LONDON CITY,PARIS (ORLY),0,0,0,6597,6597,0,-100
11/03/2020 11:02,202001,WESTERN EUROPE-EU,FRANCE,LUTON,BEZIERS,2674,2674,0,2566,2566,0,4.208885
11/03/2020 11:02,202001,WESTERN EUROPE-EU,FRANCE,LUTON,BORDEAUX,4740,4740,0,5261,5261,0,-9.90306
11/03/2020 11:02,202001,WESTERN EUROPE-EU,FRANCE,LUTON,CHAMBERY,0,0,0,789,0,789,-100
11/03/2020 11:02,202001,WESTERN EUROPE-EU,FRANCE,LUTON,GRENOBLE,4129,4129,0,2774,2774,0,48.846431
11/03/2020 11:02,202001,WESTERN EUROPE-EU,FRANCE,LUTON,LYON,8739,8739,0,8094,8094,0,7.968866
11/03/2020 11:02,202001,WESTERN EUROPE-EU,FRANCE,LUTON,MARSEILLE,2556,2556,0,2222,2222,0,15.031503
11/03/2020 11:02,202001,WESTERN EUROPE-EU,FRANCE,LUTON,NANTES,2569,2569,0,2371,2371,0,8.350907
11/03/2020 11:02,202001,WESTERN EUROPE-EU,FRANCE,LUTON,NICE,3957,3957,0,4304,4304,0,-8.062268
11/03/2020 11:02,202001,WESTERN EUROPE-EU,FRANCE,LUTON,PARIS (CHARLES DE GAULLE),24072,24072,0,22553,22553,0,6.735246
11/03/2020 11:02,202001,WESTERN EUROPE-EU,FRANCE,LUTON,PARIS (ORLY),0,0,0,1284,0,1284,-100
11/03/2020 11:02,202001,WESTERN EUROPE-EU,FRANCE,LUTON,TOULOUSE (BLAGNAC),0,0,0,2856,2856,0,-100
11/03/2020 11:02,202001,WESTERN EUROPE-EU,FRANCE,SOUTHEND,BREST,2045,2045,0,0,0,0,0
11/03/2020 11:02,202001,WESTERN EUROPE-EU,FRANCE,SOUTHEND,CAEN,379,379,0,270,270,0,40.37037
11/03/2020 11:02,202001,WESTERN EUROPE-EU,FRANCE,SOUTHEND,LYON,0,0,0,1764,1764,0,-100
11/03/2020 11:02,202001,WESTERN EUROPE-EU,FRANCE,SOUTHEND,PARIS (CHARLES DE GAULLE),3482,3482,0,3230,3230,0,7.801858
11/03/2020 11:02,202001,WESTERN EUROPE-EU,FRANCE,SOUTHEND,RENNES,2395,2395,0,2225,2225,0,7.640449
11/03/2020 11:02,202001,WESTERN EUROPE-EU,FRANCE,STANSTED,BERGERAC,4561,4561,0,4499,4499,0,1.378084
11/03/2020 11:02,202001,WESTERN EUROPE-EU,FRANCE,STANSTED,BIARRITZ,4803,4803,0,4693,4693,0,2.343916
11/03/2020 11:02,202001,WESTERN EUROPE-EU,FRANCE,STANSTED,BORDEAUX,8533,8533,0,7301,7301,0,16.874401
11/03/2020 11:02,202001,WESTERN EUROPE-EU,FRANCE,STANSTED,CARCASSONNE,3951,3951,0,3495,3495,0,13.04721
11/03/2020 11:02,202001,WESTERN EUROPE-EU,FRANCE,STANSTED,CHAMBERY,2982,842,2140,3654,958,2696,-18.390805
11/03/2020 11:02,202001,WESTERN EUROPE-EU,FRANCE,STANSTED,DINARD,3462,3462,0,3370,3370,0,2.72997
11/03/2020 11:02,202001,WESTERN EUROPE-EU,FRANCE,STANSTED,DOLE,574,574,0,533,533,0,7.692308
11/03/2020 11:02,202001,WESTERN EUROPE-EU,FRANCE,STANSTED,GRENOBLE,9983,9684,299,7430,7211,219,34.3607
11/03/2020 11:02,202001,WESTERN EUROPE-EU,FRANCE,STANSTED,LA ROCHELLE,2637,2637,0,2290,2290,0,15.152838
11/03/2020 11:02,202001,WESTERN EUROPE-EU,FRANCE,STANSTED,LIMOGES,5956,5956,0,5119,5119,0,16.35085
11/03/2020 11:02,202001,WESTERN EUROPE-EU,FRANCE,STANSTED,LYON,3151,2980,171,1638,1638,0,92.368742
11/03/2020 11:02,202001,WESTERN EUROPE-EU,FRANCE,STANSTED,MARSEILLE,9562,9562,0,9661,9661,0,-1.024739
11/03/2020 11:02,202001,WESTERN EUROPE-EU,FRANCE,STANSTED,NANTES,9732,9732,0,5315,5315,0,83.104421
11/03/2020 11:02,202001,WESTERN EUROPE-EU,FRANCE,STANSTED,NICE,6757,6757,0,11590,11590,0,-41.699741
11/03/2020 11:02,202001,WESTERN EUROPE-EU,FRANCE,STANSTED,NIMES,0,0,0,2494,2494,0,-100
11/03/2020 11:02,202001,WESTERN EUROPE-EU,FRANCE,STANSTED,PARIS (CHARLES DE GAULLE),3446,3446,0,0,0,0,0
11/03/2020 11:02,202001,WESTERN EUROPE-EU,FRANCE,STANSTED,POITIERS,3336,3336,0,3336,3336,0,0
11/03/2020 11:02,202001,WESTERN EUROPE-EU,FRANCE,STANSTED,TARBES-LOURDES INTERNATIONAL,2929,2929,0,2807,2807,0,4.346277
11/03/2020 11:02,202001,WESTERN EUROPE-EU,FRANCE,STANSTED,TOULOUSE (BLAGNAC),15687,15687,0,16454,16454,0,-4.66148
11/03/2020 11:02,202001,WESTERN EUROPE-EU,FRANCE,STANSTED,TOURS,3623,3623,0,2536,2536,0,42.862776
11/03/2020 11:02,202001,WESTERN EUROPE-EU,FRANCE,ABERDEEN,PARIS (CHARLES DE GAULLE),6369,6369,0,7035,7035,0,-9.466951
11/03/2020 11:02,202001,WESTERN EUROPE-EU,FRANCE,BELFAST CITY (GEORGE BEST),PARIS (CHARLES DE GAULLE),34,34,0,0,0,0,0
11/03/2020 11:02,202001,WESTERN EUROPE-EU,FRANCE,BELFAST INTERNATIONAL,CLERMONT FERRAND,378,0,378,0,0,0,0
11/03/2020 11:02,202001,WESTERN EUROPE-EU,FRANCE,BELFAST INTERNATIONAL,LYON,1076,1076,0,948,948,0,13.50211
11/03/2020 11:02,202001,WESTERN EUROPE-EU,FRANCE,BELFAST INTERNATIONAL,PARIS (CHARLES DE GAULLE),5635,5635,0,6103,5816,287,-7.66836
11/03/2020 11:02,202001,WESTERN EUROPE-EU,FRANCE,BIGGIN HILL,AVIGNON,6,0,6,0,0,0,0
11/03/2020 11:02,202001,WESTERN EUROPE-EU,FRANCE,BIGGIN HILL,CANNES,0,0,0,3,0,3,-100
11/03/2020 11:02,202001,WESTERN EUROPE-EU,FRANCE,BIGGIN HILL,CHAMBERY,5,0,5,33,0,33,-84.848485
11/03/2020 11:02,202001,WESTERN EUROPE-EU,FRANCE,BIGGIN HILL,NICE,0,0,0,2,0,2,-100
11/03/2020 11:02,202001,WESTERN EUROPE-EU,FRANCE,BIGGIN HILL,PARIS (LE BOURGET),0,0,0,2,0,2,-100
11/03/2020 11:02,202001,WESTERN EUROPE-EU,FRANCE,BIGGIN HILL,TOULOUSE (BLAGNAC),80,0,80,0,0,0,0
11/03/2020 11:02,202001,WESTERN EUROPE-EU,FRANCE,BIRMINGHAM,CHAMBERY,2917,624,2293,3032,663,2369,-3.792876
11/03/2020 11:02,202001,WESTERN EUROPE-EU,FRANCE,BIRMINGHAM,CLERMONT FERRAND,0,0,0,287,0,287,-100
11/03/2020 11:02,202001,WESTERN EUROPE-EU,FRANCE,BIRMINGHAM,GRENOBLE,3689,3689,0,3381,2468,913,9.109731
11/03/2020 11:02,202001,WESTERN EUROPE-EU,FRANCE,BIRMINGHAM,LYON,580,400,180,2566,2566,0,-77.396726
11/03/2020 11:02,202001,WESTERN EUROPE-EU,FRANCE,BIRMINGHAM,NANTES,87,87,0,462,462,0,-81.168831
11/03/2020 11:02,202001,WESTERN EUROPE-EU,FRANCE,BIRMINGHAM,PARIS (CHARLES DE GAULLE),29485,29485,0,31357,31357,0,-5.969959
11/03/2020 11:02,202001,WESTERN EUROPE-EU,FRANCE,BIRMINGHAM,TOULOUSE (BLAGNAC),2089,0,2089,1260,0,1260,65.793651
11/03/2020 11:02,202001,WESTERN EUROPE-EU,FRANCE,BRISTOL,BORDEAUX,2550,2550,0,2030,2030,0,25.615764
11/03/2020 11:02,202001,WESTERN EUROPE-EU,FRANCE,BRISTOL,BREST,167,167,0,0,0,0,0
11/03/2020 11:02,202001,WESTERN EUROPE-EU,FRANCE,BRISTOL,BRIVE-LA-GAILLARDE,71,0,71,0,0,0,0
11/03/2020 11:02,202001,WESTERN EUROPE-EU,FRANCE,BRISTOL,CHAMBERY,2848,0,2848,2735,0,2735,4.131627
11/03/2020 11:02,202001,WESTERN EUROPE-EU,FRANCE,BRISTOL,CLERMONT FERRAND,0,0,0,165,82,83,-100
11/03/2020 11:02,202001,WESTERN EUROPE-EU,FRANCE,BRISTOL,GRENOBLE,4640,4374,266,3522,3522,0,31.743328
11/03/2020 11:02,202001,WESTERN EUROPE-EU,FRANCE,BRISTOL,LIMOGES,0,0,0,1854,1854,0,-100
11/03/2020 11:02,202001,WESTERN EUROPE-EU,FRANCE,BRISTOL,LYON,2027,2027,0,1139,1139,0,77.963126
11/03/2020 11:02,202001,WESTERN EUROPE-EU,FRANCE,BRISTOL,NICE,2303,2303,0,2101,2101,0,9.614469
11/03/2020 11:02,202001,WESTERN EUROPE-EU,FRANCE,BRISTOL,PARIS (CHARLES DE GAULLE),18436,18400,36,12434,12434,0,48.27087
11/03/2020 11:02,202001,WESTERN EUROPE-EU,FRANCE,BRISTOL,TOULOUSE (BLAGNAC),7053,5727,1326,6715,6715,0,5.033507
11/03/2020 11:02,202001,WESTERN EUROPE-EU,FRANCE,CARDIFF WALES,CHAMBERY,341,341,0,603,603,0,-43.44942
11/03/2020 11:02,202001,WESTERN EUROPE-EU,FRANCE,CARDIFF WALES,LYON,0,0,0,78,0,78,-100
11/03/2020 11:02,202001,WESTERN EUROPE-EU,FRANCE,CARDIFF WALES,PARIS (CHARLES DE GAULLE),3801,3801,0,4110,4110,0,-7.518248
11/03/2020 11:02,202001,WESTERN EUROPE-EU,FRANCE,CARDIFF WALES,PARIS (LE BOURGET),0,0,0,58,0,58,-100
11/03/2020 11:02,202001,WESTERN EUROPE-EU,FRANCE,CARDIFF WALES,PAU,0,0,0,130,0,130,-100
11/03/2020 11:02,202001,WESTERN EUROPE-EU,FRANCE,CARDIFF WALES,TOULON / HYERES,207,0,207,0,0,0,0
11/03/2020 11:02,202001,WESTERN EUROPE-EU,FRANCE,CARDIFF WALES,TOULOUSE (BLAGNAC),0,0,0,89,89,0,-100
11/03/2020 11:02,202001,WESTERN EUROPE-EU,FRANCE,DONCASTER SHEFFIELD,CHAMBERY,14,0,14,13,0,13,7.692308
11/03/2020 11:02,202001,WESTERN EUROPE-EU,FRANCE,DONCASTER SHEFFIELD,PARIS (CHARLES DE GAULLE),0,0,0,996,996,0,-100
11/03/2020 11:02,202001,WESTERN EUROPE-EU,FRANCE,EAST MIDLANDS INTERNATIONAL,CHAMBERY,1421,0,1421,1998,0,1998,-28.878879
11/03/2020 11:02,202001,WESTERN EUROPE-EU,FRANCE,EAST MIDLANDS INTERNATIONAL,LIMOGES,2849,2849,0,3158,3158,0,-9.784674
11/03/2020 11:02,202001,WESTERN EUROPE-EU,FRANCE,EAST MIDLANDS INTERNATIONAL,PAU,138,0,138,0,0,0,0
11/03/2020 11:02,202001,WESTERN EUROPE-EU,FRANCE,EDINBURGH,BORDEAUX,159,0,159,0,0,0,0
11/03/2020 11:02,202001,WESTERN EUROPE-EU,FRANCE,EDINBURGH,CAEN,133,0,133,0,0,0,0
11/03/2020 11:02,202001,WESTERN EUROPE-EU,FRANCE,EDINBURGH,CHAMBERY,1443,0,1443,1538,0,1538,-6.176853
11/03/2020 11:02,202001,WESTERN EUROPE-EU,FRANCE,EDINBURGH,GRENOBLE,1364,1364,0,1303,1303,0,4.681504
11/03/2020 11:02,202001,WESTERN EUROPE-EU,FRANCE,EDINBURGH,LYON,1050,1050,0,938,938,0,11.940299
11/03/2020 11:02,202001,WESTERN EUROPE-EU,FRANCE,EDINBURGH,MARSEILLE,3012,3012,0,2888,2682,206,4.293629
11/03/2020 11:02,202001,WESTERN EUROPE-EU,FRANCE,EDINBURGH,MONTPELLIER,0,0,0,194,0,194,-100
11/03/2020 11:02,202001,WESTERN EUROPE-EU,FRANCE,EDINBURGH,NANTES,3535,3535,0,2527,2527,0,39.889197
11/03/2020 11:02,202001,WESTERN EUROPE-EU,FRANCE,EDINBURGH,PARIS (CHARLES DE GAULLE),28920,28920,0,26724,26724,0,8.217333
11/03/2020 11:02,202001,WESTERN EUROPE-EU,FRANCE,EDINBURGH,TOULOUSE (BLAGNAC),4105,3403,702,3162,2598,564,29.822897
11/03/2020 11:02,202001,WESTERN EUROPE-EU,FRANCE,EXETER,CHAMBERY,1670,429,1241,2208,712,1496,-24.365942
11/03/2020 11:02,202001,WESTERN EUROPE-EU,FRANCE,EXETER,PARIS (CHARLES DE GAULLE),4451,4451,0,4806,4806,0,-7.3866
11/03/2020 11:02,202001,WESTERN EUROPE-EU,FRANCE,GLASGOW,CAEN,131,0,131,0,0,0,0
11/03/2020 11:02,202001,WESTERN EUROPE-EU,FRANCE,GLASGOW,CHAMBERY,1471,0,1471,1719,0,1719,-14.426992
11/03/2020 11:02,202001,WESTERN EUROPE-EU,FRANCE,GLASGOW,GRENOBLE,1345,1345,0,1337,1337,0,0.598355
11/03/2020 11:02,202001,WESTERN EUROPE-EU,FRANCE,GLASGOW,PARIS (CHARLES DE GAULLE),5867,5867,0,7129,7129,0,-17.702343
11/03/2020 11:02,202001,WESTERN EUROPE-EU,FRANCE,GUERNSEY,DINARD,0,0,0,27,27,0,-100
11/03/2020 11:02,202001,WESTERN EUROPE-EU,FRANCE,GUERNSEY,GRENOBLE,165,165,0,160,130,30,3.125
11/03/2020 11:02,202001,WESTERN EUROPE-EU,FRANCE,JERSEY,GRENOBLE,0,0,0,36,0,36,-100
11/03/2020 11:02,202001,WESTERN EUROPE-EU,FRANCE,LEEDS BRADFORD,GRENOBLE,927,927,0,765,765,0,21.176471
11/03/2020 11:02,202001,WESTERN EUROPE-EU,FRANCE,LEEDS BRADFORD,PARIS (CHARLES DE GAULLE),4104,4104,0,3510,3510,0,16.923077
11/03/2020 11:02,202001,WESTERN EUROPE-EU,FRANCE,LIVERPOOL (JOHN LENNON),GRENOBLE,721,721,0,783,783,0,-7.918263
11/03/2020 11:02,202001,WESTERN EUROPE-EU,FRANCE,LIVERPOOL (JOHN LENNON),NICE,2853,2853,0,3065,3065,0,-6.916803
11/03/2020 11:02,202001,WESTERN EUROPE-EU,FRANCE,LIVERPOOL (JOHN LENNON),PARIS (CHARLES DE GAULLE),3638,3638,0,4899,4899,0,-25.739947
11/03/2020 11:02,202001,WESTERN EUROPE-EU,FRANCE,LIVERPOOL (JOHN LENNON),TOULOUSE (BLAGNAC),13,13,0,1857,1857,0,-99.299946
11/03/2020 11:02,202001,WESTERN EUROPE-EU,FRANCE,MANCHESTER,BORDEAUX,4534,4534,0,1635,1635,0,177.308869
11/03/2020 11:02,202001,WESTERN EUROPE-EU,FRANCE,MANCHESTER,CARCASSONNE,3174,3174,0,2503,2503,0,26.807831
11/03/2020 11:02,202001,WESTERN EUROPE-EU,FRANCE,MANCHESTER,CHAMBERY,6127,722,5405,7562,1546,6016,-18.976461
11/03/2020 11:02,202001,WESTERN EUROPE-EU,FRANCE,MANCHESTER,GRENOBLE,6389,6232,157,6112,6112,0,4.532068
11/03/2020 11:02,202001,WESTERN EUROPE-EU,FRANCE,MANCHESTER,LA ROCHELLE,344,0,344,0,0,0,0
11/03/2020 11:02,202001,WESTERN EUROPE-EU,FRANCE,MANCHESTER,LIMOGES,3520,3520,0,2952,2952,0,19.241192
11/03/2020 11:02,202001,WESTERN EUROPE-EU,FRANCE,MANCHESTER,LYON,5470,4273,1197,3774,3774,0,44.939057
11/03/2020 11:02,202001,WESTERN EUROPE-EU,FRANCE,MANCHESTER,MARSEILLE,2021,2021,0,0,0,0,0
11/03/2020 11:02,202001,WESTERN EUROPE-EU,FRANCE,MANCHESTER,NANTES,2630,2630,0,301,301,0,773.754153
11/03/2020 11:02,202001,WESTERN EUROPE-EU,FRANCE,MANCHESTER,NICE,2261,2261,0,0,0,0,0
11/03/2020 11:02,202001,WESTERN EUROPE-EU,FRANCE,MANCHESTER,PARIS (CHARLES DE GAULLE),55299,55299,0,50553,50553,0,9.388167
11/03/2020 11:02,202001,WESTERN EUROPE-EU,FRANCE,MANCHESTER,PERPIGNAN,0,0,0,76,0,76,-100
11/03/2020 11:02,202001,WESTERN EUROPE-EU,FRANCE,MANCHESTER,TOULOUSE (BLAGNAC),2702,0,2702,2504,1226,1278,7.907348
11/03/2020 11:02,202001,WESTERN EUROPE-EU,FRANCE,NEWCASTLE,GRENOBLE,1383,1383,0,1088,1088,0,27.113971
11/03/2020 11:02,202001,WESTERN EUROPE-EU,FRANCE,NEWCASTLE,MONTPELLIER,0,0,0,287,0,287,-100
11/03/2020 11:02,202001,WESTERN EUROPE-EU,FRANCE,NEWCASTLE,PARIS (CHARLES DE GAULLE),13355,13355,0,12272,12272,0,8.824967
11/03/2020 11:02,202001,WESTERN EUROPE-EU,FRANCE,NEWCASTLE,TOULON / HYERES,0,0,0,138,0,138,-100
11/03/2020 11:02,202001,WESTERN EUROPE-EU,FRANCE,SOUTHAMPTON,BERGERAC,217,217,0,1147,1147,0,-81.081081
11/03/2020 11:02,202001,WESTERN EUROPE-EU,FRANCE,SOUTHAMPTON,BORDEAUX,0,0,0,47,47,0,-100
11/03/2020 11:02,202001,WESTERN EUROPE-EU,FRANCE,SOUTHAMPTON,CHAMBERY,857,857,0,1964,1061,903,-56.364562
11/03/2020 11:02,202001,WESTERN EUROPE-EU,FRANCE,SOUTHAMPTON,LA ROCHELLE,0,0,0,64,64,0,-100
11/03/2020 11:02,202001,WESTERN EUROPE-EU,FRANCE,SOUTHAMPTON,LIMOGES,107,107,0,211,211,0,-49.2891
11/03/2020 11:02,202001,WESTERN EUROPE-EU,FRANCE,SOUTHAMPTON,LYON,0,0,0,91,91,0,-100
11/03/2020 11:02,202001,WESTERN EUROPE-EU,FRANCE,SOUTHAMPTON,NANTES,0,0,0,847,847,0,-100
11/03/2020 11:02,202001,WESTERN EUROPE-EU,FRANCE,SOUTHAMPTON,PARIS (CHARLES DE GAULLE),5355,5355,0,4614,4614,0,16.059818
11/03/2020 11:02,202001,WESTERN EUROPE-EU,FRANCE,SOUTHAMPTON,RENNES,0,0,0,307,307,0,-100
11/03/2020 11:02,202001,WESTERN EUROPE-EU,GERMANY,GATWICK,BERLIN (SCHONEFELD),13131,13131,0,11355,10970,385,15.640687
11/03/2020 11:02,202001,WESTERN EUROPE-EU,GERMANY,GATWICK,BERLIN (TEGEL),22217,22217,0,22221,22221,0,-0.018001
11/03/2020 11:02,202001,WESTERN EUROPE-EU,GERMANY,GATWICK,COLOGNE BONN,3182,3182,0,3313,3313,0,-3.95412
11/03/2020 11:02,202001,WESTERN EUROPE-EU,GERMANY,GATWICK,DUSSELDORF,12114,12114,0,0,0,0,0
11/03/2020 11:02,202001,WESTERN EUROPE-EU,GERMANY,GATWICK,FRIEDRICHSHAFEN,5287,2333,2954,5907,3394,2513,-10.496022
11/03/2020 11:02,202001,WESTERN EUROPE-EU,GERMANY,GATWICK,HAMBURG,7599,7599,0,9582,9582,0,-20.695053
11/03/2020 11:02,202001,WESTERN EUROPE-EU,GERMANY,GATWICK,MUNICH,15903,15732,171,17045,16938,107,-6.699912
11/03/2020 11:02,202001,WESTERN EUROPE-EU,GERMANY,GATWICK,NUREMBERG,1091,1091,0,817,817,0,33.537332
11/03/2020 11:02,202001,WESTERN EUROPE-EU,GERMANY,GATWICK,STUTTGART,6232,6232,0,5832,5832,0,6.858711
11/03/2020 11:02,202001,WESTERN EUROPE-EU,GERMANY,HEATHROW,BERLIN (TEGEL),43556,43556,0,55531,55531,0,-21.564532
11/03/2020 11:02,202001,WESTERN EUROPE-EU,GERMANY,HEATHROW,COLOGNE BONN,13461,13461,0,12442,12442,0,8.190002
11/03/2020 11:02,202001,WESTERN EUROPE-EU,GERMANY,HEATHROW,DUSSELDORF,57088,57088,0,55246,55246,0,3.334178
11/03/2020 11:02,202001,WESTERN EUROPE-EU,GERMANY,HEATHROW,FRANKFURT MAIN,101514,101514,0,101972,101972,0,-0.449143
11/03/2020 11:02,202001,WESTERN EUROPE-EU,GERMANY,HEATHROW,HAMBURG,46526,46526,0,43430,43430,0,7.128713
11/03/2020 11:02,202001,WESTERN EUROPE-EU,GERMANY,HEATHROW,HANOVER,11619,11619,0,12561,12561,0,-7.499403
11/03/2020 11:02,202001,WESTERN EUROPE-EU,GERMANY,HEATHROW,MUNICH,92337,92337,0,88760,88760,0,4.029968
11/03/2020 11:02,202001,WESTERN EUROPE-EU,GERMANY,HEATHROW,STUTTGART,23042,23042,0,22044,22044,0,4.527309
11/03/2020 11:02,202001,WESTERN EUROPE-EU,GERMANY,LONDON CITY,BERLIN (TEGEL),11260,11260,0,7924,7924,0,42.09995
11/03/2020 11:02,202001,WESTERN EUROPE-EU,GERMANY,LONDON CITY,DUSSELDORF,6702,6702,0,11363,11363,0,-41.019097
11/03/2020 11:02,202001,WESTERN EUROPE-EU,GERMANY,LONDON CITY,FRANKFURT MAIN,16322,16322,0,17814,17814,0,-8.375435
11/03/2020 11:02,202001,WESTERN EUROPE-EU,GERMANY,LONDON CITY,MUNICH,8628,8628,0,0,0,0,0
11/03/2020 11:02,202001,WESTERN EUROPE-EU,GERMANY,LUTON,BERLIN (SCHONEFELD),9450,9450,0,9531,9531,0,-0.849858
11/03/2020 11:02,202001,WESTERN EUROPE-EU,GERMANY,LUTON,DORTMUND,5897,5897,0,6855,6855,0,-13.975201
11/03/2020 11:02,202001,WESTERN EUROPE-EU,GERMANY,LUTON,MUNICH,3791,3791,0,3627,3627,0,4.521643
11/03/2020 11:02,202001,WESTERN EUROPE-EU,GERMANY,SOUTHEND,COLOGNE BONN,0,0,0,1107,1107,0,-100
11/03/2020 11:02,202001,WESTERN EUROPE-EU,GERMANY,SOUTHEND,PADERBORN,0,0,0,26,26,0,-100
11/03/2020 11:02,202001,WESTERN EUROPE-EU,GERMANY,STANSTED,BERLIN (SCHONEFELD),33593,33593,0,36305,36305,0,-7.470045
11/03/2020 11:02,202001,WESTERN EUROPE-EU,GERMANY,STANSTED,BERLIN (TEGEL),350,350,0,300,300,0,16.666667
11/03/2020 11:02,202001,WESTERN EUROPE-EU,GERMANY,STANSTED,BREMEN,13085,13085,0,11614,11614,0,12.665748
11/03/2020 11:02,202001,WESTERN EUROPE-EU,GERMANY,STANSTED,COLOGNE BONN,22432,22432,0,31341,31341,0,-28.426023
11/03/2020 11:02,202001,WESTERN EUROPE-EU,GERMANY,STANSTED,DORTMUND,9442,9442,0,9352,9352,0,0.962361
11/03/2020 11:02,202001,WESTERN EUROPE-EU,GERMANY,STANSTED,DRESDEN,3125,3125,0,0,0,0,0
11/03/2020 11:02,202001,WESTERN EUROPE-EU,GERMANY,STANSTED,FRANKFURT MAIN,25001,25001,0,17461,17461,0,43.181948
11/03/2020 11:02,202001,WESTERN EUROPE-EU,GERMANY,STANSTED,FRIEDRICHSHAFEN,702,702,0,0,0,0,0
11/03/2020 11:02,202001,WESTERN EUROPE-EU,GERMANY,STANSTED,HAHN,0,0,0,5713,5713,0,-100
11/03/2020 11:02,202001,WESTERN EUROPE-EU,GERMANY,STANSTED,HAMBURG,7253,7253,0,11961,11961,0,-39.361257
11/03/2020 11:02,202001,WESTERN EUROPE-EU,GERMANY,STANSTED,HANOVER,0,0,0,6150,5923,227,-100
11/03/2020 11:02,202001,WESTERN EUROPE-EU,GERMANY,STANSTED,KARLSRUHE/BADEN BADEN,10084,10084,0,9715,9715,0,3.79825
11/03/2020 11:02,202001,WESTERN EUROPE-EU,GERMANY,STANSTED,LEIPZIG,0,0,0,3502,3502,0,-100
11/03/2020 11:02,202001,WESTERN EUROPE-EU,GERMANY,STANSTED,MEMMINGEN ALLGAU,6850,6850,0,5931,5931,0,15.494858
11/03/2020 11:02,202001,WESTERN EUROPE-EU,GERMANY,STANSTED,MUNICH,3244,3244,0,11379,11379,0,-71.491344
11/03/2020 11:02,202001,WESTERN EUROPE-EU,GERMANY,STANSTED,NUREMBERG,13523,13523,0,13183,13183,0,2.579079
11/03/2020 11:02,202001,WESTERN EUROPE-EU,GERMANY,STANSTED,STUTTGART,0,0,0,187,187,0,-100
11/03/2020 11:02,202001,WESTERN EUROPE-EU,GERMANY,BELFAST INTERNATIONAL,BERLIN (SCHONEFELD),0,0,0,2906,2906,0,-100
11/03/2020 11:02,202001,WESTERN EUROPE-EU,GERMANY,BIGGIN HILL,BERLIN (SCHONEFELD),2,0,2,0,0,0,0
11/03/2020 11:02,202001,WESTERN EUROPE-EU,GERMANY,BIRMINGHAM,BERLIN (TEGEL),0,0,0,3484,3484,0,-100
11/03/2020 11:02,202001,WESTERN EUROPE-EU,GERMANY,BIRMINGHAM,DUSSELDORF,21256,21256,0,22913,22913,0,-7.231703
11/03/2020 11:02,202001,WESTERN EUROPE-EU,GERMANY,BIRMINGHAM,FRANKFURT MAIN,21804,21804,0,19817,19817,0,10.026745
11/03/2020 11:02,202001,WESTERN EUROPE-EU,GERMANY,BIRMINGHAM,FRIEDRICHSHAFEN,178,178,0,0,0,0,0
11/03/2020 11:02,202001,WESTERN EUROPE-EU,GERMANY,BIRMINGHAM,HAMBURG,0,0,0,2038,2038,0,-100
11/03/2020 11:02,202001,WESTERN EUROPE-EU,GERMANY,BIRMINGHAM,HANOVER,0,0,0,2279,2279,0,-100
11/03/2020 11:02,202001,WESTERN EUROPE-EU,GERMANY,BIRMINGHAM,MUNICH,16190,16190,0,16302,15732,570,-0.687032
11/03/2020 11:02,202001,WESTERN EUROPE-EU,GERMANY,BIRMINGHAM,STUTTGART,3591,3591,0,4200,4200,0,-14.5
11/03/2020 11:02,202001,WESTERN EUROPE-EU,GERMANY,BRISTOL,BERLIN (SCHONEFELD),6060,6060,0,5654,5654,0,7.180757
11/03/2020 11:02,202001,WESTERN EUROPE-EU,GERMANY,BRISTOL,COLOGNE BONN,4979,4979,0,4253,4253,0,17.070303
11/03/2020 11:02,202001,WESTERN EUROPE-EU,GERMANY,BRISTOL,DUSSELDORF,0,0,0,1173,1173,0,-100
11/03/2020 11:02,202001,WESTERN EUROPE-EU,GERMANY,BRISTOL,FRANKFURT MAIN,0,0,0,3487,3487,0,-100
11/03/2020 11:02,202001,WESTERN EUROPE-EU,GERMANY,BRISTOL,HAMBURG,0,0,0,687,687,0,-100
11/03/2020 11:02,202001,WESTERN EUROPE-EU,GERMANY,BRISTOL,MUNICH,0,0,0,2720,2720,0,-100
11/03/2020 11:02,202001,WESTERN EUROPE-EU,GERMANY,CARDIFF WALES,BERLIN (SCHONEFELD),0,0,0,155,155,0,-100
11/03/2020 11:02,202001,WESTERN EUROPE-EU,GERMANY,CARDIFF WALES,BERLIN (TEGEL),0,0,0,276,276,0,-100
11/03/2020 11:02,202001,WESTERN EUROPE-EU,GERMANY,CARDIFF WALES,DUSSELDORF,91,91,0,0,0,0,0
11/03/2020 11:02,202001,WESTERN EUROPE-EU,GERMANY,CARDIFF WALES,MUNICH,0,0,0,488,488,0,-100
11/03/2020 11:02,202001,WESTERN EUROPE-EU,GERMANY,DUNDEE,MUNSTER-OSNABRUCK,25,0,25,0,0,0,0
11/03/2020 11:02,202001,WESTERN EUROPE-EU,GERMANY,EAST MIDLANDS INTERNATIONAL,BERLIN (SCHONEFELD),3327,3327,0,2923,2923,0,13.821416
11/03/2020 11:02,202001,WESTERN EUROPE-EU,GERMANY,EDINBURGH,BERLIN (SCHONEFELD),6687,6687,0,8289,8289,0,-19.326819
11/03/2020 11:02,202001,WESTERN EUROPE-EU,GERMANY,EDINBURGH,BERLIN (TEGEL),6200,6200,0,5197,5197,0,19.299596
11/03/2020 11:02,202001,WESTERN EUROPE-EU,GERMANY,EDINBURGH,COLOGNE BONN,524,524,0,493,493,0,6.288032
11/03/2020 11:02,202001,WESTERN EUROPE-EU,GERMANY,EDINBURGH,DUSSELDORF,569,569,0,600,600,0,-5.166667
11/03/2020 11:02,202001,WESTERN EUROPE-EU,GERMANY,EDINBURGH,FRANKFURT MAIN,8695,8695,0,8018,8018,0,8.443502
11/03/2020 11:02,202001,WESTERN EUROPE-EU,GERMANY,EDINBURGH,HAMBURG,4862,4862,0,7758,7758,0,-37.329209
11/03/2020 11:02,202001,WESTERN EUROPE-EU,GERMANY,EDINBURGH,MEMMINGEN ALLGAU,0,0,0,2055,2055,0,-100
11/03/2020 11:02,202001,WESTERN EUROPE-EU,GERMANY,EDINBURGH,MUNICH,8120,8120,0,7539,7539,0,7.706592
11/03/2020 11:02,202001,WESTERN EUROPE-EU,GERMANY,EDINBURGH,STUTTGART,0,0,0,574,574,0,-100
11/03/2020 11:02,202001,WESTERN EUROPE-EU,GERMANY,GLASGOW,BERLIN (SCHONEFELD),4019,4019,0,5522,5522,0,-27.218399
11/03/2020 11:02,202001,WESTERN EUROPE-EU,GERMANY,GLASGOW,DUSSELDORF,490,490,0,4391,4391,0,-88.840811
11/03/2020 11:02,202001,WESTERN EUROPE-EU,GERMANY,GLASGOW,FRANKFURT MAIN,5287,5287,0,5644,5644,0,-6.325301
11/03/2020 11:02,202001,WESTERN EUROPE-EU,GERMANY,GLASGOW,MUNICH,0,0,0,2432,2432,0,-100
11/03/2020 11:02,202001,WESTERN EUROPE-EU,GERMANY,LEEDS BRADFORD,BERLIN (SCHONEFELD),0,0,0,406,406,0,-100
11/03/2020 11:02,202001,WESTERN EUROPE-EU,GERMANY,LEEDS BRADFORD,DUSSELDORF,0,0,0,1839,1839,0,-100
11/03/2020 11:02,202001,WESTERN EUROPE-EU,GERMANY,LIVERPOOL (JOHN LENNON),BERLIN (SCHONEFELD),3111,3111,0,2822,2822,0,10.240964
11/03/2020 11:02,202001,WESTERN EUROPE-EU,GERMANY,MANCHESTER,BERLIN (SCHONEFELD),13103,13103,0,26008,26008,0,-49.619348
11/03/2020 11:02,202001,WESTERN EUROPE-EU,GERMANY,MANCHESTER,BERLIN (TEGEL),12795,12795,0,0,0,0,0
11/03/2020 11:02,202001,WESTERN EUROPE-EU,GERMANY,MANCHESTER,BREMEN,0,0,0,88,88,0,-100
11/03/2020 11:02,202001,WESTERN EUROPE-EU,GERMANY,MANCHESTER,COLOGNE BONN,7854,7854,0,6500,6500,0,20.830769
11/03/2020 11:02,202001,WESTERN EUROPE-EU,GERMANY,MANCHESTER,DUSSELDORF,22417,22417,0,22851,22851,0,-1.89926
11/03/2020 11:02,202001,WESTERN EUROPE-EU,GERMANY,MANCHESTER,FRANKFURT MAIN,30112,30112,0,37293,37293,0,-19.255624
11/03/2020 11:02,202001,WESTERN EUROPE-EU,GERMANY,MANCHESTER,HAHN,0,0,0,40,40,0,-100
11/03/2020 11:02,202001,WESTERN EUROPE-EU,GERMANY,MANCHESTER,HAMBURG,10433,10433,0,13792,13792,0,-24.354698
11/03/2020 11:02,202001,WESTERN EUROPE-EU,GERMANY,MANCHESTER,HANOVER,2217,2217,0,2377,2130,247,-6.731174
11/03/2020 11:02,202001,WESTERN EUROPE-EU,GERMANY,MANCHESTER,MUNICH,27853,27853,0,24536,24242,294,13.518911
11/03/2020 11:02,202001,WESTERN EUROPE-EU,GERMANY,MANCHESTER,NUREMBERG,0,0,0,5539,5539,0,-100
11/03/2020 11:02,202001,WESTERN EUROPE-EU,GERMANY,MANCHESTER,STUTTGART,0,0,0,4681,4681,0,-100
11/03/2020 11:02,202001,WESTERN EUROPE-EU,GERMANY,NEWCASTLE,BERLIN (SCHONEFELD),0,0,0,2180,2180,0,-100
11/03/2020 11:02,202001,WESTERN EUROPE-EU,GERMANY,NEWCASTLE,DUSSELDORF,3748,3748,0,3306,3306,0,13.369631
11/03/2020 11:02,202001,WESTERN EUROPE-EU,GERMANY,NEWCASTLE,MUNICH,184,92,92,0,0,0,0
11/03/2020 11:02,202001,WESTERN EUROPE-EU,GERMANY,SOUTHAMPTON,DUSSELDORF,0,0,0,1983,1983,0,-100
11/03/2020 11:02,202001,WESTERN EUROPE-EU,GERMANY,SOUTHAMPTON,HAMBURG,0,0,0,26,26,0,-100
11/03/2020 11:02,202001,WESTERN EUROPE-EU,GIBRALTAR,GATWICK,GIBRALTAR,6297,6297,0,5742,5742,0,9.665622
11/03/2020 11:02,202001,WESTERN EUROPE-EU,GIBRALTAR,HEATHROW,GIBRALTAR,9522,9522,0,10542,10542,0,-9.675583
11/03/2020 11:02,202001,WESTERN EUROPE-EU,GIBRALTAR,LUTON,GIBRALTAR,2237,2237,0,2529,2529,0,-11.546066
11/03/2020 11:02,202001,WESTERN EUROPE-EU,GIBRALTAR,BRISTOL,GIBRALTAR,2743,2743,0,3685,3685,0,-25.563094
11/03/2020 11:02,202001,WESTERN EUROPE-EU,GIBRALTAR,MANCHESTER,GIBRALTAR,3175,3175,0,2967,2967,0,7.010448
11/03/2020 11:02,202001,WESTERN EUROPE-EU,GREECE,GATWICK,ATHENS,14731,14547,184,13534,13534,0,8.844392
11/03/2020 11:02,202001,WESTERN EUROPE-EU,GREECE,GATWICK,HERAKLION,0,0,0,737,0,737,-100
11/03/2020 11:02,202001,WESTERN EUROPE-EU,GREECE,GATWICK,SALONIKA,6648,6648,0,5380,5380,0,23.568773
11/03/2020 11:02,202001,WESTERN EUROPE-EU,GREECE,HEATHROW,ATHENS,48046,48046,0,46470,46470,0,3.391435
11/03/2020 11:02,202001,WESTERN EUROPE-EU,GREECE,LUTON,ATHENS,15281,15281,0,15163,15163,0,0.77821
11/03/2020 11:02,202001,WESTERN EUROPE-EU,GREECE,LUTON,SALONIKA,2729,2729,0,0,0,0,0
11/03/2020 11:02,202001,WESTERN EUROPE-EU,GREECE,STANSTED,ATHENS,12600,12600,0,16879,16879,0,-25.351028
11/03/2020 11:02,202001,WESTERN EUROPE-EU,GREECE,STANSTED,SALONIKA,9433,9433,0,9241,9241,0,2.077697
11/03/2020 11:02,202001,WESTERN EUROPE-EU,GREECE,BRISTOL,ATHENS,3480,3480,0,2621,2621,0,32.77375
11/03/2020 11:02,202001,WESTERN EUROPE-EU,GREECE,EDINBURGH,ATHENS,4597,4597,0,3745,3745,0,22.750334
11/03/2020 11:02,202001,WESTERN EUROPE-EU,GREECE,MANCHESTER,ATHENS,6543,6543,0,5649,5649,0,15.82581
11/03/2020 11:02,202001,WESTERN EUROPE-EU,GREECE,MANCHESTER,HERAKLION,0,0,0,548,0,548,-100
11/03/2020 11:02,202001,WESTERN EUROPE-EU,GREECE,MANCHESTER,SALONIKA,5666,5666,0,2631,2631,0,115.355378
11/03/2020 11:02,202001,WESTERN EUROPE-EU,IRISH REPUBLIC,GATWICK,CORK,9939,9939,0,9347,9347,0,6.333583
11/03/2020 11:02,202001,WESTERN EUROPE-EU,IRISH REPUBLIC,GATWICK,DUBLIN,99026,99026,0,108425,108425,0,-8.668665
11/03/2020 11:02,202001,WESTERN EUROPE-EU,IRISH REPUBLIC,GATWICK,IRELAND WEST(KNOCK),4360,4360,0,4405,4405,0,-1.021566
11/03/2020 11:02,202001,WESTERN EUROPE-EU,IRISH REPUBLIC,GATWICK,SHANNON,7852,7852,0,7662,7662,0,2.47977
11/03/2020 11:02,202001,WESTERN EUROPE-EU,IRISH REPUBLIC,HEATHROW,CORK,27449,27449,0,27426,27426,0,0.083862
11/03/2020 11:02,202001,WESTERN EUROPE-EU,IRISH REPUBLIC,HEATHROW,DUBLIN,132633,132633,0,124684,124684,0,6.375317
11/03/2020 11:02,202001,WESTERN EUROPE-EU,IRISH REPUBLIC,HEATHROW,SHANNON,17358,17358,0,18338,18338,0,-5.344094
11/03/2020 11:02,202001,WESTERN EUROPE-EU,IRISH REPUBLIC,LONDON CITY,DUBLIN,33699,33628,71,33315,33315,0,1.152634
11/03/2020 11:02,202001,WESTERN EUROPE-EU,IRISH REPUBLIC,LUTON,CORK,6054,6054,0,5337,5337,0,13.434514
11/03/2020 11:02,202001,WESTERN EUROPE-EU,IRISH REPUBLIC,LUTON,DUBLIN,28257,28257,0,28266,28266,0,-0.03184
11/03/2020 11:02,202001,WESTERN EUROPE-EU,IRISH REPUBLIC,LUTON,IRELAND WEST(KNOCK),7690,7690,0,7807,7807,0,-1.498655
11/03/2020 11:02,202001,WESTERN EUROPE-EU,IRISH REPUBLIC,LUTON,KERRY COUNTY,7173,7173,0,7373,7373,0,-2.7126
11/03/2020 11:02,202001,WESTERN EUROPE-EU,IRISH REPUBLIC,LUTON,SHANNON,122,122,0,41,41,0,197.560976
11/03/2020 11:02,202001,WESTERN EUROPE-EU,IRISH REPUBLIC,SOUTHEND,DUBLIN,7785,7785,0,4797,4797,0,62.288931
11/03/2020 11:02,202001,WESTERN EUROPE-EU,IRISH REPUBLIC,STANSTED,CORK,25910,25910,0,24848,24848,0,4.273986
11/03/2020 11:02,202001,WESTERN EUROPE-EU,IRISH REPUBLIC,STANSTED,DUBLIN,70219,70219,0,69094,69094,0,1.628217
11/03/2020 11:02,202001,WESTERN EUROPE-EU,IRISH REPUBLIC,STANSTED,IRELAND WEST(KNOCK),11210,11210,0,10727,10727,0,4.502657
11/03/2020 11:02,202001,WESTERN EUROPE-EU,IRISH REPUBLIC,STANSTED,KERRY COUNTY,6103,6103,0,5663,5663,0,7.769733
11/03/2020 11:02,202001,WESTERN EUROPE-EU,IRISH REPUBLIC,STANSTED,SHANNON,15409,15409,0,14725,14725,0,4.645161
11/03/2020 11:02,202001,WESTERN EUROPE-EU,IRISH REPUBLIC,ABERDEEN,DUBLIN,2466,2466,0,3357,3357,0,-26.541555
11/03/2020 11:02,202001,WESTERN EUROPE-EU,IRISH REPUBLIC,BIRMINGHAM,CORK,5484,5484,0,5521,5521,0,-0.670168
11/03/2020 11:02,202001,WESTERN EUROPE-EU,IRISH REPUBLIC,BIRMINGHAM,DUBLIN,74833,74833,0,76224,76086,138,-1.824885
11/03/2020 11:02,202001,WESTERN EUROPE-EU,IRISH REPUBLIC,BIRMINGHAM,IRELAND WEST(KNOCK),764,764,0,1325,1325,0,-42.339623
11/03/2020 11:02,202001,WESTERN EUROPE-EU,IRISH REPUBLIC,BIRMINGHAM,SHANNON,2121,2121,0,3053,3053,0,-30.52735
11/03/2020 11:02,202001,WESTERN EUROPE-EU,IRISH REPUBLIC,BOURNEMOUTH,DUBLIN,4360,4360,0,0,0,0,0
11/03/2020 11:02,202001,WESTERN EUROPE-EU,IRISH REPUBLIC,BRISTOL,CORK,2069,2069,0,2814,2814,0,-26.474769
11/03/2020 11:02,202001,WESTERN EUROPE-EU,IRISH REPUBLIC,BRISTOL,DUBLIN,31019,31019,0,30764,30764,0,0.828891
11/03/2020 11:02,202001,WESTERN EUROPE-EU,IRISH REPUBLIC,BRISTOL,IRELAND WEST(KNOCK),3296,3296,0,2873,2873,0,14.723286
11/03/2020 11:02,202001,WESTERN EUROPE-EU,IRISH REPUBLIC,BRISTOL,SHANNON,0,0,0,43,0,43,-100
11/03/2020 11:02,202001,WESTERN EUROPE-EU,IRISH REPUBLIC,CARDIFF WALES,CORK,316,316,0,1008,967,41,-68.650794
11/03/2020 11:02,202001,WESTERN EUROPE-EU,IRISH REPUBLIC,CARDIFF WALES,DUBLIN,6649,6649,0,6088,6088,0,9.214849
11/03/2020 11:02,202001,WESTERN EUROPE-EU,IRISH REPUBLIC,CARDIFF WALES,SHANNON,116,0,116,0,0,0,0
11/03/2020 11:02,202001,WESTERN EUROPE-EU,IRISH REPUBLIC,DONCASTER SHEFFIELD,DUBLIN,0,0,0,1370,1370,0,-100
11/03/2020 11:02,202001,WESTERN EUROPE-EU,IRISH REPUBLIC,EAST MIDLANDS INTERNATIONAL,DUBLIN,14654,14654,0,14186,14186,0,3.299027
11/03/2020 11:02,202001,WESTERN EUROPE-EU,IRISH REPUBLIC,EAST MIDLANDS INTERNATIONAL,IRELAND WEST(KNOCK),4523,4523,0,4067,4067,0,11.212196
11/03/2020 11:02,202001,WESTERN EUROPE-EU,IRISH REPUBLIC,EDINBURGH,CORK,3530,3530,0,3412,3412,0,3.458382
11/03/2020 11:02,202001,WESTERN EUROPE-EU,IRISH REPUBLIC,EDINBURGH,DUBLIN,47785,47761,24,44982,44982,0,6.231381
11/03/2020 11:02,202001,WESTERN EUROPE-EU,IRISH REPUBLIC,EDINBURGH,IRELAND WEST(KNOCK),768,768,0,1272,1272,0,-39.622642
11/03/2020 11:02,202001,WESTERN EUROPE-EU,IRISH REPUBLIC,EDINBURGH,SHANNON,1252,1252,0,1269,1269,0,-1.339638
11/03/2020 11:02,202001,WESTERN EUROPE-EU,IRISH REPUBLIC,EXETER,DUBLIN,1492,1492,0,1868,1868,0,-20.12848
11/03/2020 11:02,202001,WESTERN EUROPE-EU,IRISH REPUBLIC,EXETER,SHANNON,0,0,0,78,0,78,-100
11/03/2020 11:02,202001,WESTERN EUROPE-EU,IRISH REPUBLIC,GLASGOW,CORK,1151,1151,0,1272,1272,0,-9.512579
11/03/2020 11:02,202001,WESTERN EUROPE-EU,IRISH REPUBLIC,GLASGOW,DONEGAL,418,418,0,403,403,0,3.722084
11/03/2020 11:02,202001,WESTERN EUROPE-EU,IRISH REPUBLIC,GLASGOW,DUBLIN,35440,35440,0,35652,35652,0,-0.594637
11/03/2020 11:02,202001,WESTERN EUROPE-EU,IRISH REPUBLIC,INVERNESS,DUBLIN,499,499,0,449,449,0,11.135857
11/03/2020 11:02,202001,WESTERN EUROPE-EU,IRISH REPUBLIC,ISLE OF MAN,DUBLIN,2559,2559,0,2762,2762,0,-7.349747
11/03/2020 11:02,202001,WESTERN EUROPE-EU,IRISH REPUBLIC,LEEDS BRADFORD,DUBLIN,24023,24023,0,22871,22871,0,5.036946
11/03/2020 11:02,202001,WESTERN EUROPE-EU,IRISH REPUBLIC,LIVERPOOL (JOHN LENNON),CORK,6358,6358,0,6146,6146,0,3.449398
11/03/2020 11:02,202001,WESTERN EUROPE-EU,IRISH REPUBLIC,LIVERPOOL (JOHN LENNON),DUBLIN,27815,27815,0,27524,27524,0,1.057259
11/03/2020 11:02,202001,WESTERN EUROPE-EU,IRISH REPUBLIC,LIVERPOOL (JOHN LENNON),IRELAND WEST(KNOCK),7336,7336,0,6795,6795,0,7.961737
11/03/2020 11:02,202001,WESTERN EUROPE-EU,IRISH REPUBLIC,MANCHESTER,CORK,7586,7586,0,6960,6960,0,8.994253
11/03/2020 11:02,202001,WESTERN EUROPE-EU,IRISH REPUBLIC,MANCHESTER,DUBLIN,80991,80991,0,79760,79760,0,1.54338
11/03/2020 11:02,202001,WESTERN EUROPE-EU,IRISH REPUBLIC,MANCHESTER,IRELAND WEST(KNOCK),1292,1292,0,1951,1951,0,-33.77755
11/03/2020 11:02,202001,WESTERN EUROPE-EU,IRISH REPUBLIC,MANCHESTER,SHANNON,6832,6832,0,6310,6310,0,8.272583
11/03/2020 11:02,202001,WESTERN EUROPE-EU,IRISH REPUBLIC,NEWCASTLE,DUBLIN,16516,16516,0,16360,16360,0,0.953545
11/03/2020 11:02,202001,WESTERN EUROPE-EU,IRISH REPUBLIC,NEWQUAY,DUBLIN,1320,1320,0,1353,1353,0,-2.439024
11/03/2020 11:02,202001,WESTERN EUROPE-EU,IRISH REPUBLIC,SOUTHAMPTON,CORK,0,0,0,586,586,0,-100
11/03/2020 11:02,202001,WESTERN EUROPE-EU,IRISH REPUBLIC,SOUTHAMPTON,DUBLIN,8122,8122,0,9540,9540,0,-14.863732
11/03/2020 11:02,202001,WESTERN EUROPE-EU,ITALY,GATWICK,ANCONA,1699,1699,0,0,0,0,0
11/03/2020 11:02,202001,WESTERN EUROPE-EU,ITALY,GATWICK,BARI (PALESE),334,334,0,2000,2000,0,-83.3
11/03/2020 11:02,202001,WESTERN EUROPE-EU,ITALY,GATWICK,BERGAMO,5092,5092,0,0,0,0,0
11/03/2020 11:02,202001,WESTERN EUROPE-EU,ITALY,GATWICK,BOLOGNA,4973,4973,0,5715,5715,0,-12.983377
11/03/2020 11:02,202001,WESTERN EUROPE-EU,ITALY,GATWICK,CAGLIARI (ELMAS),0,0,0,657,657,0,-100
11/03/2020 11:02,202001,WESTERN EUROPE-EU,ITALY,GATWICK,CATANIA (FONTANAROSSA),3894,3894,0,3977,3977,0,-2.087
11/03/2020 11:02,202001,WESTERN EUROPE-EU,ITALY,GATWICK,FLORENCE,9473,9473,0,8105,8105,0,16.87847
11/03/2020 11:02,202001,WESTERN EUROPE-EU,ITALY,GATWICK,GENOA,3724,3724,0,2823,2823,0,31.916401
11/03/2020 11:02,202001,WESTERN EUROPE-EU,ITALY,GATWICK,MILAN (LINATE),21212,21212,0,20630,20630,0,2.821134
11/03/2020 11:02,202001,WESTERN EUROPE-EU,ITALY,GATWICK,MILAN (MALPENSA),37128,37128,0,39848,39848,0,-6.825939
11/03/2020 11:02,202001,WESTERN EUROPE-EU,ITALY,GATWICK,NAPLES,16178,16178,0,15928,15928,0,1.569563
11/03/2020 11:02,202001,WESTERN EUROPE-EU,ITALY,GATWICK,OLBIA,2136,2136,0,2261,2261,0,-5.528527
11/03/2020 11:02,202001,WESTERN EUROPE-EU,ITALY,GATWICK,PALERMO,584,584,0,2746,2746,0,-78.732702
11/03/2020 11:02,202001,WESTERN EUROPE-EU,ITALY,GATWICK,PISA,7601,7601,0,8528,8528,0,-10.870075
11/03/2020 11:02,202001,WESTERN EUROPE-EU,ITALY,GATWICK,ROME (FIUMICINO),48481,48481,0,46894,46894,0,3.384228
11/03/2020 11:02,202001,WESTERN EUROPE-EU,ITALY,GATWICK,TURIN,28312,24295,4017,26994,21904,5090,4.882566
11/03/2020 11:02,202001,WESTERN EUROPE-EU,ITALY,GATWICK,VENICE,39062,39062,0,38608,38608,0,1.175922
11/03/2020 11:02,202001,WESTERN EUROPE-EU,ITALY,GATWICK,VERONA VILLAFRANCA,13142,11840,1302,13093,11513,1580,0.374246
11/03/2020 11:02,202001,WESTERN EUROPE-EU,ITALY,HEATHROW,BOLOGNA,20102,20102,0,19312,19312,0,4.090721
11/03/2020 11:02,202001,WESTERN EUROPE-EU,ITALY,HEATHROW,MILAN (LINATE),53774,53774,0,46298,46298,0,16.147566
11/03/2020 11:02,202001,WESTERN EUROPE-EU,ITALY,HEATHROW,MILAN (MALPENSA),10029,10029,0,14359,14359,0,-30.155303
11/03/2020 11:02,202001,WESTERN EUROPE-EU,ITALY,HEATHROW,PISA,5542,5542,0,3719,3719,0,49.018553
11/03/2020 11:02,202001,WESTERN EUROPE-EU,ITALY,HEATHROW,ROME (FIUMICINO),56973,56973,0,61309,61309,0,-7.072371
11/03/2020 11:02,202001,WESTERN EUROPE-EU,ITALY,HEATHROW,VENICE,9397,9397,0,13269,13269,0,-29.180797
11/03/2020 11:02,202001,WESTERN EUROPE-EU,ITALY,LONDON CITY,BOLOGNA,98,98,0,0,0,0,0
11/03/2020 11:02,202001,WESTERN EUROPE-EU,ITALY,LONDON CITY,FLORENCE,6734,6614,120,4585,4585,0,46.870229
11/03/2020 11:02,202001,WESTERN EUROPE-EU,ITALY,LONDON CITY,MILAN (LINATE),26465,26396,69,26685,26685,0,-0.824433
11/03/2020 11:02,202001,WESTERN EUROPE-EU,ITALY,LONDON CITY,ROME (FIUMICINO),3056,3056,0,2493,2493,0,22.583233
11/03/2020 11:02,202001,WESTERN EUROPE-EU,ITALY,LUTON,ALGHERO (FERTILIA),2009,2009,0,2213,2213,0,-9.218256
11/03/2020 11:02,202001,WESTERN EUROPE-EU,ITALY,LUTON,BARI (PALESE),0,0,0,2128,2128,0,-100
11/03/2020 11:02,202001,WESTERN EUROPE-EU,ITALY,LUTON,BOLOGNA,10063,10063,0,9734,9734,0,3.379905
11/03/2020 11:02,202001,WESTERN EUROPE-EU,ITALY,LUTON,CATANIA (FONTANAROSSA),3007,3007,0,3171,3171,0,-5.17187
11/03/2020 11:02,202001,WESTERN EUROPE-EU,ITALY,LUTON,FLORENCE,699,699,0,0,0,0,0
11/03/2020 11:02,202001,WESTERN EUROPE-EU,ITALY,LUTON,MILAN (MALPENSA),7949,7949,0,8198,8198,0,-3.037326
11/03/2020 11:02,202001,WESTERN EUROPE-EU,ITALY,LUTON,NAPLES,6021,6021,0,5946,5946,0,1.261352
11/03/2020 11:02,202001,WESTERN EUROPE-EU,ITALY,LUTON,PISA,771,771,0,2021,2021,0,-61.850569
11/03/2020 11:02,202001,WESTERN EUROPE-EU,ITALY,LUTON,ROME (FIUMICINO),4263,4263,0,4530,4530,0,-5.89404
11/03/2020 11:02,202001,WESTERN EUROPE-EU,ITALY,LUTON,TURIN,1443,1443,0,2337,2337,0,-38.254172
11/03/2020 11:02,202001,WESTERN EUROPE-EU,ITALY,LUTON,VENICE,4341,4341,0,3175,3175,0,36.724409
11/03/2020 11:02,202001,WESTERN EUROPE-EU,ITALY,LUTON,VERONA VILLAFRANCA,0,0,0,813,813,0,-100
11/03/2020 11:02,202001,WESTERN EUROPE-EU,ITALY,SOUTHEND,BERGAMO,2743,2743,0,0,0,0,0
11/03/2020 11:02,202001,WESTERN EUROPE-EU,ITALY,SOUTHEND,CATANIA (FONTANAROSSA),0,0,0,568,568,0,-100
11/03/2020 11:02,202001,WESTERN EUROPE-EU,ITALY,SOUTHEND,TREVISO,3233,3233,0,0,0,0,0
11/03/2020 11:02,202001,WESTERN EUROPE-EU,ITALY,STANSTED,ANCONA,6086,6086,0,6672,6672,0,-8.782974
11/03/2020 11:02,202001,WESTERN EUROPE-EU,ITALY,STANSTED,BARI (PALESE),10080,10080,0,11505,11505,0,-12.385919
11/03/2020 11:02,202001,WESTERN EUROPE-EU,ITALY,STANSTED,BERGAMO,42999,42999,0,39274,39274,0,9.484646
11/03/2020 11:02,202001,WESTERN EUROPE-EU,ITALY,STANSTED,BOLOGNA,19063,19063,0,19168,19168,0,-0.547788
11/03/2020 11:02,202001,WESTERN EUROPE-EU,ITALY,STANSTED,BRINDISI,4291,4291,0,5070,5070,0,-15.364892
11/03/2020 11:02,202001,WESTERN EUROPE-EU,ITALY,STANSTED,CAGLIARI (ELMAS),8853,8853,0,8811,8811,0,0.476677
11/03/2020 11:02,202001,WESTERN EUROPE-EU,ITALY,STANSTED,GENOA,5131,5131,0,4773,4773,0,7.500524
11/03/2020 11:02,202001,WESTERN EUROPE-EU,ITALY,STANSTED,LAMETIA-TERME,4305,4305,0,3019,3019,0,42.596886
11/03/2020 11:02,202001,WESTERN EUROPE-EU,ITALY,STANSTED,MILAN (MALPENSA),23745,23745,0,19141,19141,0,24.05308
11/03/2020 11:02,202001,WESTERN EUROPE-EU,ITALY,STANSTED,NAPLES,18689,18689,0,16703,16703,0,11.89008
11/03/2020 11:02,202001,WESTERN EUROPE-EU,ITALY,STANSTED,PALERMO,10334,10334,0,7987,7987,0,29.385251
11/03/2020 11:02,202001,WESTERN EUROPE-EU,ITALY,STANSTED,PERUGIA,5772,5772,0,5396,5396,0,6.968125
11/03/2020 11:02,202001,WESTERN EUROPE-EU,ITALY,STANSTED,PESCARA,7952,7952,0,6976,6976,0,13.990826
11/03/2020 11:02,202001,WESTERN EUROPE-EU,ITALY,STANSTED,PISA,21744,21744,0,20631,20631,0,5.394794
11/03/2020 11:02,202001,WESTERN EUROPE-EU,ITALY,STANSTED,ROME (CIAMPINO),49551,49551,0,49366,49366,0,0.374752
11/03/2020 11:02,202001,WESTERN EUROPE-EU,ITALY,STANSTED,TREVISO,0,0,0,26957,26957,0,-100
11/03/2020 11:02,202001,WESTERN EUROPE-EU,ITALY,STANSTED,TRIESTE (RONCHI DEI LEGIONARI),4922,4922,0,3930,3930,0,25.24173
11/03/2020 11:02,202001,WESTERN EUROPE-EU,ITALY,STANSTED,TURIN,13481,12222,1259,13426,12116,1310,0.409653
11/03/2020 11:02,202001,WESTERN EUROPE-EU,ITALY,STANSTED,VENICE,27650,27650,0,0,0,0,0
11/03/2020 11:02,202001,WESTERN EUROPE-EU,ITALY,STANSTED,VERONA VILLAFRANCA,4576,4576,0,4365,4365,0,4.833906
11/03/2020 11:02,202001,WESTERN EUROPE-EU,ITALY,BELFAST INTERNATIONAL,BERGAMO,1179,1179,0,2419,2419,0,-51.260852
11/03/2020 11:02,202001,WESTERN EUROPE-EU,ITALY,BELFAST INTERNATIONAL,VENICE,0,0,0,1741,1741,0,-100
11/03/2020 11:02,202001,WESTERN EUROPE-EU,ITALY,BELFAST INTERNATIONAL,VERONA VILLAFRANCA,1423,0,1423,1331,0,1331,6.912096
11/03/2020 11:02,202001,WESTERN EUROPE-EU,ITALY,BIRMINGHAM,MILAN (MALPENSA),410,410,0,3690,3690,0,-88.888889
11/03/2020 11:02,202001,WESTERN EUROPE-EU,ITALY,BIRMINGHAM,ROME (FIUMICINO),2936,2936,0,2855,2855,0,2.837128
11/03/2020 11:02,202001,WESTERN EUROPE-EU,ITALY,BIRMINGHAM,TURIN,3634,1960,1674,3621,2085,1536,0.359017
11/03/2020 11:02,202001,WESTERN EUROPE-EU,ITALY,BIRMINGHAM,VERONA VILLAFRANCA,3660,2034,1626,4192,2994,1198,-12.69084
11/03/2020 11:02,202001,WESTERN EUROPE-EU,ITALY,BOURNEMOUTH,TURIN,0,0,0,746,0,746,-100
11/03/2020 11:02,202001,WESTERN EUROPE-EU,ITALY,BRISTOL,BERGAMO,3739,3739,0,4469,4469,0,-16.334751
11/03/2020 11:02,202001,WESTERN EUROPE-EU,ITALY,BRISTOL,CATANIA (FONTANAROSSA),646,646,0,1845,1845,0,-64.98645
11/03/2020 11:02,202001,WESTERN EUROPE-EU,ITALY,BRISTOL,MILAN (MALPENSA),5423,5423,0,0,0,0,0
11/03/2020 11:02,202001,WESTERN EUROPE-EU,ITALY,BRISTOL,NAPLES,795,795,0,2392,2392,0,-66.764214
11/03/2020 11:02,202001,WESTERN EUROPE-EU,ITALY,BRISTOL,PISA,848,848,0,2023,2023,0,-58.082056
11/03/2020 11:02,202001,WESTERN EUROPE-EU,ITALY,BRISTOL,ROME (FIUMICINO),6258,6258,0,5873,5873,0,6.555423
11/03/2020 11:02,202001,WESTERN EUROPE-EU,ITALY,BRISTOL,TURIN,3401,1973,1428,2576,1035,1541,32.026398
11/03/2020 11:02,202001,WESTERN EUROPE-EU,ITALY,BRISTOL,VENICE,10819,10819,0,9859,9859,0,9.737296
11/03/2020 11:02,202001,WESTERN EUROPE-EU,ITALY,BRISTOL,VERONA VILLAFRANCA,1418,0,1418,1408,0,1408,0.710227
11/03/2020 11:02,202001,WESTERN EUROPE-EU,ITALY,CARDIFF WALES,MILAN (MALPENSA),0,0,0,294,294,0,-100
11/03/2020 11:02,202001,WESTERN EUROPE-EU,ITALY,CARDIFF WALES,ROME (FIUMICINO),0,0,0,473,473,0,-100
11/03/2020 11:02,202001,WESTERN EUROPE-EU,ITALY,EAST MIDLANDS INTERNATIONAL,BERGAMO,4609,4609,0,4859,4859,0,-5.145092
11/03/2020 11:02,202001,WESTERN EUROPE-EU,ITALY,EAST MIDLANDS INTERNATIONAL,TREVISO,2469,2469,0,3122,3122,0,-20.916079
11/03/2020 11:02,202001,WESTERN EUROPE-EU,ITALY,EDINBURGH,BERGAMO,10662,10662,0,6474,6474,0,64.689527
11/03/2020 11:02,202001,WESTERN EUROPE-EU,ITALY,EDINBURGH,BOLOGNA,2943,2943,0,2945,2945,0,-0.067912
11/03/2020 11:02,202001,WESTERN EUROPE-EU,ITALY,EDINBURGH,MILAN (MALPENSA),7428,7428,0,7402,7402,0,0.351256
11/03/2020 11:02,202001,WESTERN EUROPE-EU,ITALY,EDINBURGH,NAPLES,895,895,0,1922,1922,0,-53.433923
11/03/2020 11:02,202001,WESTERN EUROPE-EU,ITALY,EDINBURGH,ROME (CIAMPINO),7490,7490,0,7345,7345,0,1.974132
11/03/2020 11:02,202001,WESTERN EUROPE-EU,ITALY,EDINBURGH,TREVISO,2741,2741,0,3963,3963,0,-30.835226
11/03/2020 11:02,202001,WESTERN EUROPE-EU,ITALY,EDINBURGH,TURIN,1308,1308,0,970,970,0,34.845361
11/03/2020 11:02,202001,WESTERN EUROPE-EU,ITALY,EDINBURGH,VENICE,5896,5896,0,3371,3371,0,74.903589
11/03/2020 11:02,202001,WESTERN EUROPE-EU,ITALY,EDINBURGH,VERONA VILLAFRANCA,1772,1050,722,713,0,713,148.527349
11/03/2020 11:02,202001,WESTERN EUROPE-EU,ITALY,GLASGOW,ROME (FIUMICINO),2772,2772,0,0,0,0,0
11/03/2020 11:02,202001,WESTERN EUROPE-EU,ITALY,GLASGOW,TURIN,1453,0,1453,1457,0,1457,-0.274537
11/03/2020 11:02,202001,WESTERN EUROPE-EU,ITALY,GLASGOW,VENICE,2185,2185,0,2271,2271,0,-3.786878
11/03/2020 11:02,202001,WESTERN EUROPE-EU,ITALY,LEEDS BRADFORD,TURIN,0,0,0,413,413,0,-100
11/03/2020 11:02,202001,WESTERN EUROPE-EU,ITALY,LIVERPOOL (JOHN LENNON),MILAN (MALPENSA),0,0,0,3131,3131,0,-100
11/03/2020 11:02,202001,WESTERN EUROPE-EU,ITALY,LIVERPOOL (JOHN LENNON),ROME (FIUMICINO),0,0,0,2945,2945,0,-100
11/03/2020 11:02,202001,WESTERN EUROPE-EU,ITALY,LIVERPOOL (JOHN LENNON),VENICE,0,0,0,2131,2131,0,-100
11/03/2020 11:02,202001,WESTERN EUROPE-EU,ITALY,MANCHESTER,BERGAMO,13593,13593,0,10188,10188,0,33.421673
11/03/2020 11:02,202001,WESTERN EUROPE-EU,ITALY,MANCHESTER,BOLOGNA,3090,3090,0,3090,3090,0,0
11/03/2020 11:02,202001,WESTERN EUROPE-EU,ITALY,MANCHESTER,CATANIA (FONTANAROSSA),976,976,0,2781,2781,0,-64.904711
11/03/2020 11:02,202001,WESTERN EUROPE-EU,ITALY,MANCHESTER,MILAN (MALPENSA),14426,14426,0,9239,9239,0,56.14244
11/03/2020 11:02,202001,WESTERN EUROPE-EU,ITALY,MANCHESTER,NAPLES,2714,2714,0,3116,3116,0,-12.901155
11/03/2020 11:02,202001,WESTERN EUROPE-EU,ITALY,MANCHESTER,PISA,593,593,0,2668,2668,0,-77.773613
11/03/2020 11:02,202001,WESTERN EUROPE-EU,ITALY,MANCHESTER,ROME (CIAMPINO),9734,9734,0,10885,10885,0,-10.574185
11/03/2020 11:02,202001,WESTERN EUROPE-EU,ITALY,MANCHESTER,ROME (FIUMICINO),5840,5840,0,5472,5472,0,6.725146
11/03/2020 11:02,202001,WESTERN EUROPE-EU,ITALY,MANCHESTER,TREVISO,4024,4024,0,4596,4596,0,-12.445605
11/03/2020 11:02,202001,WESTERN EUROPE-EU,ITALY,MANCHESTER,TURIN,6033,3545,2488,7503,4548,2955,-19.592163
11/03/2020 11:02,202001,WESTERN EUROPE-EU,ITALY,MANCHESTER,VENICE,6159,6159,0,5407,5407,0,13.907897
11/03/2020 11:02,202001,WESTERN EUROPE-EU,ITALY,MANCHESTER,VERONA VILLAFRANCA,3379,1818,1561,1675,0,1675,101.731343
11/03/2020 11:02,202001,WESTERN EUROPE-EU,ITALY,NEWCASTLE,TURIN,1426,1426,0,1372,1372,0,3.93586
11/03/2020 11:02,202001,WESTERN EUROPE-EU,LUXEMBOURG,GATWICK,LUXEMBOURG,5467,5467,0,5109,5109,0,7.007242
11/03/2020 11:02,202001,WESTERN EUROPE-EU,LUXEMBOURG,HEATHROW,LUXEMBOURG,13266,13266,0,12757,12757,0,3.989966
11/03/2020 11:02,202001,WESTERN EUROPE-EU,LUXEMBOURG,LONDON CITY,LUXEMBOURG,11121,11121,0,12701,12701,0,-12.439965
11/03/2020 11:02,202001,WESTERN EUROPE-EU,LUXEMBOURG,STANSTED,LUXEMBOURG,8980,8980,0,8842,8842,0,1.560733
11/03/2020 11:02,202001,WESTERN EUROPE-EU,LUXEMBOURG,EDINBURGH,LUXEMBOURG,3258,3258,0,0,0,0,0
11/03/2020 11:02,202001,WESTERN EUROPE-EU,LUXEMBOURG,MANCHESTER,LUXEMBOURG,1108,1108,0,1804,1804,0,-38.580931
11/03/2020 11:02,202001,WESTERN EUROPE-EU,MALTA,GATWICK,MALTA,16935,16935,0,16230,16043,187,4.343808
11/03/2020 11:02,202001,WESTERN EUROPE-EU,MALTA,HEATHROW,MALTA,14116,14116,0,13251,13251,0,6.527809
11/03/2020 11:02,202001,WESTERN EUROPE-EU,MALTA,LUTON,MALTA,6066,6066,0,5789,5789,0,4.784937
11/03/2020 11:02,202001,WESTERN EUROPE-EU,MALTA,SOUTHEND,MALTA,2671,2671,0,2836,2836,0,-5.818054
11/03/2020 11:02,202001,WESTERN EUROPE-EU,MALTA,STANSTED,MALTA,5477,5477,0,5829,5829,0,-6.038772
11/03/2020 11:02,202001,WESTERN EUROPE-EU,MALTA,BELFAST INTERNATIONAL,MALTA,0,0,0,1996,1996,0,-100
11/03/2020 11:02,202001,WESTERN EUROPE-EU,MALTA,BIRMINGHAM,MALTA,4688,4688,0,3951,3951,0,18.653505
11/03/2020 11:02,202001,WESTERN EUROPE-EU,MALTA,BOURNEMOUTH,MALTA,2419,2419,0,2254,2254,0,7.320319
11/03/2020 11:02,202001,WESTERN EUROPE-EU,MALTA,BRISTOL,MALTA,4354,4354,0,3858,3858,0,12.856402
11/03/2020 11:02,202001,WESTERN EUROPE-EU,MALTA,CARDIFF WALES,MALTA,2599,2599,0,0,0,0,0
11/03/2020 11:02,202001,WESTERN EUROPE-EU,MALTA,EAST MIDLANDS INTERNATIONAL,MALTA,4069,4069,0,3946,3946,0,3.117081
11/03/2020 11:02,202001,WESTERN EUROPE-EU,MALTA,EDINBURGH,MALTA,4028,4028,0,2882,2882,0,39.764053
11/03/2020 11:02,202001,WESTERN EUROPE-EU,MALTA,EXETER,MALTA,1876,1876,0,0,0,0,0
11/03/2020 11:02,202001,WESTERN EUROPE-EU,MALTA,LEEDS BRADFORD,MALTA,2680,2680,0,2321,2321,0,15.467471
11/03/2020 11:02,202001,WESTERN EUROPE-EU,MALTA,LIVERPOOL (JOHN LENNON),MALTA,2726,2726,0,2547,2547,0,7.027876
11/03/2020 11:02,202001,WESTERN EUROPE-EU,MALTA,MANCHESTER,MALTA,11550,11550,0,11731,10081,1650,-1.54292
11/03/2020 11:02,202001,WESTERN EUROPE-EU,MALTA,NEWCASTLE,MALTA,268,268,0,1252,1252,0,-78.594249
11/03/2020 11:02,202001,WESTERN EUROPE-EU,MALTA,PRESTWICK,MALTA,0,0,0,999,999,0,-100
11/03/2020 11:02,202001,WESTERN EUROPE-EU,NETHERLANDS,GATWICK,AMSTERDAM,86635,86635,0,88806,88806,0,-2.444655
11/03/2020 11:02,202001,WESTERN EUROPE-EU,NETHERLANDS,HEATHROW,AMSTERDAM,137673,137673,0,133699,133699,0,2.972348
11/03/2020 11:02,202001,WESTERN EUROPE-EU,NETHERLANDS,LONDON CITY,AMSTERDAM,48335,48265,70,47200,47200,0,2.404661
11/03/2020 11:02,202001,WESTERN EUROPE-EU,NETHERLANDS,LONDON CITY,ROTTERDAM,11712,11712,0,12532,12532,0,-6.543249
11/03/2020 11:02,202001,WESTERN EUROPE-EU,NETHERLANDS,LUTON,AMSTERDAM,68770,68770,0,62245,62245,0,10.48277
11/03/2020 11:02,202001,WESTERN EUROPE-EU,NETHERLANDS,LUTON,EINDHOVEN,0,0,0,228,228,0,-100
11/03/2020 11:02,202001,WESTERN EUROPE-EU,NETHERLANDS,SOUTHEND,AMSTERDAM,12750,12750,0,15330,15330,0,-16.829746
11/03/2020 11:02,202001,WESTERN EUROPE-EU,NETHERLANDS,SOUTHEND,GRONINGEN,1662,1662,0,3116,3116,0,-46.662388
11/03/2020 11:02,202001,WESTERN EUROPE-EU,NETHERLANDS,STANSTED,AMSTERDAM,29768,29768,0,30425,30425,0,-2.159408
11/03/2020 11:02,202001,WESTERN EUROPE-EU,NETHERLANDS,STANSTED,EINDHOVEN,21580,21580,0,20870,20870,0,3.402012
11/03/2020 11:02,202001,WESTERN EUROPE-EU,NETHERLANDS,ABERDEEN,AMSTERDAM,24646,24646,0,21524,21524,0,14.504739
11/03/2020 11:02,202001,WESTERN EUROPE-EU,NETHERLANDS,BELFAST CITY (GEORGE BEST),AMSTERDAM,3115,3115,0,3050,3050,0,2.131148
11/03/2020 11:02,202001,WESTERN EUROPE-EU,NETHERLANDS,BELFAST INTERNATIONAL,AMSTERDAM,9555,9467,88,9331,9331,0,2.4006
11/03/2020 11:02,202001,WESTERN EUROPE-EU,NETHERLANDS,BIRMINGHAM,AMSTERDAM,54990,54990,0,56664,56664,0,-2.954257
11/03/2020 11:02,202001,WESTERN EUROPE-EU,NETHERLANDS,BRISTOL,AMSTERDAM,35322,35322,0,34079,34079,0,3.647407
11/03/2020 11:02,202001,WESTERN EUROPE-EU,NETHERLANDS,CARDIFF WALES,AMSTERDAM,12042,12042,0,11609,11609,0,3.729865
11/03/2020 11:02,202001,WESTERN EUROPE-EU,NETHERLANDS,DONCASTER SHEFFIELD,AMSTERDAM,0,0,0,4710,4710,0,-100
11/03/2020 11:02,202001,WESTERN EUROPE-EU,NETHERLANDS,DUNDEE,AMSTERDAM,19,0,19,0,0,0,0
11/03/2020 11:02,202001,WESTERN EUROPE-EU,NETHERLANDS,EAST MIDLANDS INTERNATIONAL,AMSTERDAM,2882,2882,0,3412,3412,0,-15.533411
11/03/2020 11:02,202001,WESTERN EUROPE-EU,NETHERLANDS,EDINBURGH,AMSTERDAM,43986,43986,0,45703,45703,0,-3.756865
11/03/2020 11:02,202001,WESTERN EUROPE-EU,NETHERLANDS,EDINBURGH,EINDHOVEN,2711,2711,0,3838,3838,0,-29.364252
11/03/2020 11:02,202001,WESTERN EUROPE-EU,NETHERLANDS,EXETER,AMSTERDAM,4663,4663,0,4691,4691,0,-0.596888
11/03/2020 11:02,202001,WESTERN EUROPE-EU,NETHERLANDS,GLASGOW,AMSTERDAM,30456,30365,91,29630,29630,0,2.787715
11/03/2020 11:02,202001,WESTERN EUROPE-EU,NETHERLANDS,HUMBERSIDE,AMSTERDAM,10564,10564,0,9710,9710,0,8.795057
11/03/2020 11:02,202001,WESTERN EUROPE-EU,NETHERLANDS,INVERNESS,AMSTERDAM,3404,3404,0,3604,3604,0,-5.54939
11/03/2020 11:02,202001,WESTERN EUROPE-EU,NETHERLANDS,LEEDS BRADFORD,AMSTERDAM,21481,21481,0,19700,19700,0,9.040609
11/03/2020 11:02,202001,WESTERN EUROPE-EU,NETHERLANDS,LIVERPOOL (JOHN LENNON),AMSTERDAM,18265,18265,0,19373,19373,0,-5.7193
11/03/2020 11:02,202001,WESTERN EUROPE-EU,NETHERLANDS,MANCHESTER,AMSTERDAM,89230,89230,0,86960,86960,0,2.610396
11/03/2020 11:02,202001,WESTERN EUROPE-EU,NETHERLANDS,MANCHESTER,EINDHOVEN,4263,4263,0,5194,5194,0,-17.924528
11/03/2020 11:02,202001,WESTERN EUROPE-EU,NETHERLANDS,MANCHESTER,ROTTERDAM,336,0,336,0,0,0,0
11/03/2020 11:02,202001,WESTERN EUROPE-EU,NETHERLANDS,NEWCASTLE,AMSTERDAM,30075,30075,0,27748,27748,0,8.38619
11/03/2020 11:02,202001,WESTERN EUROPE-EU,NETHERLANDS,NORWICH,AMSTERDAM,11401,11401,0,10884,10884,0,4.750092
11/03/2020 11:02,202001,WESTERN EUROPE-EU,NETHERLANDS,PRESTWICK,AMSTERDAM,0,0,0,1,0,1,-100
11/03/2020 11:02,202001,WESTERN EUROPE-EU,NETHERLANDS,SOUTHAMPTON,AMSTERDAM,12006,12006,0,15069,15069,0,-20.326498
11/03/2020 11:02,202001,WESTERN EUROPE-EU,NETHERLANDS,TEESSIDE INTERNATIONAL AIRPORT,AMSTERDAM,8981,8981,0,8221,8221,0,9.244617
11/03/2020 11:02,202001,WESTERN EUROPE-EU,PORTUGAL(EXCLUDING MADEIRA),GATWICK,FARO,21332,21332,0,20329,20329,0,4.933838
11/03/2020 11:02,202001,WESTERN EUROPE-EU,PORTUGAL(EXCLUDING MADEIRA),GATWICK,LISBON,24487,24487,0,22113,22113,0,10.735766
11/03/2020 11:02,202001,WESTERN EUROPE-EU,PORTUGAL(EXCLUDING MADEIRA),GATWICK,OPORTO (PORTUGAL),23200,23200,0,20338,20338,0,14.07218
11/03/2020 11:02,202001,WESTERN EUROPE-EU,PORTUGAL(EXCLUDING MADEIRA),HEATHROW,FARO,63,0,63,0,0,0,0
11/03/2020 11:02,202001,WESTERN EUROPE-EU,PORTUGAL(EXCLUDING MADEIRA),HEATHROW,LISBON,65897,65897,0,56009,56009,0,17.654306
11/03/2020 11:02,202001,WESTERN EUROPE-EU,PORTUGAL(EXCLUDING MADEIRA),LONDON CITY,LISBON,0,0,0,4820,4820,0,-100
11/03/2020 11:02,202001,WESTERN EUROPE-EU,PORTUGAL(EXCLUDING MADEIRA),LONDON CITY,OPORTO (PORTUGAL),0,0,0,2062,2062,0,-100
11/03/2020 11:02,202001,WESTERN EUROPE-EU,PORTUGAL(EXCLUDING MADEIRA),LUTON,FARO,6058,6058,0,5806,5806,0,4.340338
11/03/2020 11:02,202001,WESTERN EUROPE-EU,PORTUGAL(EXCLUDING MADEIRA),LUTON,LISBON,27597,27597,0,28987,28987,0,-4.795253
11/03/2020 11:02,202001,WESTERN EUROPE-EU,PORTUGAL(EXCLUDING MADEIRA),LUTON,OPORTO (PORTUGAL),6557,6557,0,3573,3573,0,83.515253
11/03/2020 11:02,202001,WESTERN EUROPE-EU,PORTUGAL(EXCLUDING MADEIRA),SOUTHEND,FARO,2854,2854,0,2713,2713,0,5.197199
11/03/2020 11:02,202001,WESTERN EUROPE-EU,PORTUGAL(EXCLUDING MADEIRA),STANSTED,AZORES PONTA DELGADA,1234,1234,0,1210,1210,0,1.983471
11/03/2020 11:02,202001,WESTERN EUROPE-EU,PORTUGAL(EXCLUDING MADEIRA),STANSTED,FARO,13474,13474,0,12454,12454,0,8.19014
11/03/2020 11:02,202001,WESTERN EUROPE-EU,PORTUGAL(EXCLUDING MADEIRA),STANSTED,LISBON,38505,38505,0,31647,31647,0,21.670301
11/03/2020 11:02,202001,WESTERN EUROPE-EU,PORTUGAL(EXCLUDING MADEIRA),STANSTED,OPORTO (PORTUGAL),28543,28356,187,27096,27096,0,5.340272
11/03/2020 11:02,202001,WESTERN EUROPE-EU,PORTUGAL(EXCLUDING MADEIRA),BELFAST INTERNATIONAL,FARO,1636,1636,0,3710,3710,0,-55.902965
11/03/2020 11:02,202001,WESTERN EUROPE-EU,PORTUGAL(EXCLUDING MADEIRA),BIGGIN HILL,FARO,11,0,11,0,0,0,0
11/03/2020 11:02,202001,WESTERN EUROPE-EU,PORTUGAL(EXCLUDING MADEIRA),BIGGIN HILL,LISBON,0,0,0,7,0,7,-100
11/03/2020 11:02,202001,WESTERN EUROPE-EU,PORTUGAL(EXCLUDING MADEIRA),BIRMINGHAM,FARO,7884,7884,0,4706,4706,0,67.530812
11/03/2020 11:02,202001,WESTERN EUROPE-EU,PORTUGAL(EXCLUDING MADEIRA),BIRMINGHAM,OPORTO (PORTUGAL),3261,3261,0,0,0,0,0
11/03/2020 11:02,202001,WESTERN EUROPE-EU,PORTUGAL(EXCLUDING MADEIRA),BOURNEMOUTH,FARO,3217,3217,0,2623,2623,0,22.645825
11/03/2020 11:02,202001,WESTERN EUROPE-EU,PORTUGAL(EXCLUDING MADEIRA),BRISTOL,FARO,8650,8650,0,10409,10409,0,-16.898838
11/03/2020 11:02,202001,WESTERN EUROPE-EU,PORTUGAL(EXCLUDING MADEIRA),BRISTOL,LISBON,6443,6443,0,6030,6030,0,6.849088
11/03/2020 11:02,202001,WESTERN EUROPE-EU,PORTUGAL(EXCLUDING MADEIRA),BRISTOL,OPORTO (PORTUGAL),2713,2713,0,3243,3243,0,-16.342892
11/03/2020 11:02,202001,WESTERN EUROPE-EU,PORTUGAL(EXCLUDING MADEIRA),CARDIFF WALES,FARO,0,0,0,312,312,0,-100
11/03/2020 11:02,202001,WESTERN EUROPE-EU,PORTUGAL(EXCLUDING MADEIRA),EAST MIDLANDS INTERNATIONAL,FARO,3536,3536,0,4855,4855,0,-27.167868
11/03/2020 11:02,202001,WESTERN EUROPE-EU,PORTUGAL(EXCLUDING MADEIRA),EDINBURGH,FARO,3265,3265,0,3314,3314,0,-1.478576
11/03/2020 11:02,202001,WESTERN EUROPE-EU,PORTUGAL(EXCLUDING MADEIRA),EDINBURGH,LISBON,5889,5889,0,5499,5499,0,7.092199
11/03/2020 11:02,202001,WESTERN EUROPE-EU,PORTUGAL(EXCLUDING MADEIRA),EDINBURGH,OPORTO (PORTUGAL),0,0,0,3043,3043,0,-100
11/03/2020 11:02,202001,WESTERN EUROPE-EU,PORTUGAL(EXCLUDING MADEIRA),EXETER,FARO,0,0,0,269,269,0,-100
11/03/2020 11:02,202001,WESTERN EUROPE-EU,PORTUGAL(EXCLUDING MADEIRA),GLASGOW,FARO,3003,3003,0,3200,3200,0,-6.15625
11/03/2020 11:02,202001,WESTERN EUROPE-EU,PORTUGAL(EXCLUDING MADEIRA),LEEDS BRADFORD,FARO,881,881,0,3517,3517,0,-74.950242
11/03/2020 11:02,202001,WESTERN EUROPE-EU,PORTUGAL(EXCLUDING MADEIRA),LIVERPOOL (JOHN LENNON),FARO,1249,1249,0,4650,4650,0,-73.139785
11/03/2020 11:02,202001,WESTERN EUROPE-EU,PORTUGAL(EXCLUDING MADEIRA),LIVERPOOL (JOHN LENNON),OPORTO (PORTUGAL),2782,2782,0,2426,2426,0,14.674361
11/03/2020 11:02,202001,WESTERN EUROPE-EU,PORTUGAL(EXCLUDING MADEIRA),MANCHESTER,FARO,11234,11234,0,16836,16836,0,-33.273937
11/03/2020 11:02,202001,WESTERN EUROPE-EU,PORTUGAL(EXCLUDING MADEIRA),MANCHESTER,LISBON,21847,21847,0,22113,22113,0,-1.202912
11/03/2020 11:02,202001,WESTERN EUROPE-EU,PORTUGAL(EXCLUDING MADEIRA),MANCHESTER,OPORTO (PORTUGAL),6889,6889,0,6118,6118,0,12.602158
11/03/2020 11:02,202001,WESTERN EUROPE-EU,PORTUGAL(EXCLUDING MADEIRA),NEWCASTLE,FARO,2448,2448,0,2700,2700,0,-9.333333
11/03/2020 11:02,202001,WESTERN EUROPE-EU,PORTUGAL(EXCLUDING MADEIRA),PRESTWICK,FARO,2498,2498,0,1299,1299,0,92.301771
11/03/2020 11:02,202001,WESTERN EUROPE-EU,PORTUGAL(MADEIRA),GATWICK,FUNCHAL,18799,17107,1692,19840,18246,1594,-5.246976
11/03/2020 11:02,202001,WESTERN EUROPE-EU,PORTUGAL(MADEIRA),STANSTED,FUNCHAL,3576,3576,0,3738,3738,0,-4.333868
11/03/2020 11:02,202001,WESTERN EUROPE-EU,PORTUGAL(MADEIRA),BELFAST INTERNATIONAL,FUNCHAL,0,0,0,850,850,0,-100
11/03/2020 11:02,202001,WESTERN EUROPE-EU,PORTUGAL(MADEIRA),BIRMINGHAM,FUNCHAL,3288,3288,0,2673,2485,188,23.007856
11/03/2020 11:02,202001,WESTERN EUROPE-EU,PORTUGAL(MADEIRA),BRISTOL,FUNCHAL,4569,4569,0,3308,3308,0,38.11971
11/03/2020 11:02,202001,WESTERN EUROPE-EU,PORTUGAL(MADEIRA),EAST MIDLANDS INTERNATIONAL,FUNCHAL,2713,1323,1390,2618,1244,1374,3.628724
11/03/2020 11:02,202001,WESTERN EUROPE-EU,PORTUGAL(MADEIRA),EDINBURGH,FUNCHAL,1419,1419,0,1328,1328,0,6.85241
11/03/2020 11:02,202001,WESTERN EUROPE-EU,PORTUGAL(MADEIRA),GLASGOW,FUNCHAL,1746,1746,0,1245,1245,0,40.240964
11/03/2020 11:02,202001,WESTERN EUROPE-EU,PORTUGAL(MADEIRA),JERSEY,FUNCHAL,2194,0,2194,2548,0,2548,-13.89325
11/03/2020 11:02,202001,WESTERN EUROPE-EU,PORTUGAL(MADEIRA),LEEDS BRADFORD,FUNCHAL,1609,1609,0,1473,1473,0,9.232858
11/03/2020 11:02,202001,WESTERN EUROPE-EU,PORTUGAL(MADEIRA),MANCHESTER,FUNCHAL,7764,6308,1456,6802,5438,1364,14.142899
11/03/2020 11:02,202001,WESTERN EUROPE-EU,PORTUGAL(MADEIRA),NEWCASTLE,FUNCHAL,1304,1304,0,1087,1087,0,19.963201
11/03/2020 11:02,202001,WESTERN EUROPE-EU,SLOVENIA,GATWICK,LJUBLJANA,4132,4132,0,4849,4849,0,-14.786554
11/03/2020 11:02,202001,WESTERN EUROPE-EU,SLOVENIA,LUTON,LJUBLJANA,0,0,0,4695,4695,0,-100
11/03/2020 11:02,202001,WESTERN EUROPE-EU,SLOVENIA,STANSTED,LJUBLJANA,4912,4912,0,4719,4719,0,4.08985
11/03/2020 11:02,202001,WESTERN EUROPE-EU,SPAIN,GATWICK,ALICANTE,37852,37852,0,36963,35202,1761,2.405108
11/03/2020 11:02,202001,WESTERN EUROPE-EU,SPAIN,GATWICK,ALMERIA,4711,4711,0,4757,4757,0,-0.966996
11/03/2020 11:02,202001,WESTERN EUROPE-EU,SPAIN,GATWICK,ASTURIAS,3496,3496,0,0,0,0,0
11/03/2020 11:02,202001,WESTERN EUROPE-EU,SPAIN,GATWICK,BARCELONA,91923,91923,0,91303,91303,0,0.679058
11/03/2020 11:02,202001,WESTERN EUROPE-EU,SPAIN,GATWICK,BILBAO,16222,16222,0,9041,9041,0,79.427055
11/03/2020 11:02,202001,WESTERN EUROPE-EU,SPAIN,GATWICK,GRANADA,972,972,0,3028,3028,0,-67.899604
11/03/2020 11:02,202001,WESTERN EUROPE-EU,SPAIN,GATWICK,LIEIDA,0,0,0,1263,0,1263,-100
11/03/2020 11:02,202001,WESTERN EUROPE-EU,SPAIN,GATWICK,MADRID,70511,70511,0,77211,77211,0,-8.67752
11/03/2020 11:02,202001,WESTERN EUROPE-EU,SPAIN,GATWICK,MAHON,2038,2038,0,2255,2255,0,-9.62306
11/03/2020 11:02,202001,WESTERN EUROPE-EU,SPAIN,GATWICK,MALAGA,47841,46402,1439,50765,49390,1375,-5.759874
11/03/2020 11:02,202001,WESTERN EUROPE-EU,SPAIN,GATWICK,MURCIA INTERNATIONAL,7493,7493,0,2266,2266,0,230.670786
11/03/2020 11:02,202001,WESTERN EUROPE-EU,SPAIN,GATWICK,MURCIA SAN JAVIER,0,0,0,3557,3557,0,-100
11/03/2020 11:02,202001,WESTERN EUROPE-EU,SPAIN,GATWICK,PALMA DE MALLORCA,12602,12602,0,20631,20631,0,-38.917163
11/03/2020 11:02,202001,WESTERN EUROPE-EU,SPAIN,GATWICK,REUS,0,0,0,182,0,182,-100
11/03/2020 11:02,202001,WESTERN EUROPE-EU,SPAIN,GATWICK,SEVILLE,15325,15325,0,15620,15620,0,-1.888604
11/03/2020 11:02,202001,WESTERN EUROPE-EU,SPAIN,GATWICK,VALENCIA,16963,16963,0,19586,19586,0,-13.392219
11/03/2020 11:02,202001,WESTERN EUROPE-EU,SPAIN,HEATHROW,A CORUNA,8597,8597,0,8480,8480,0,1.379717
11/03/2020 11:02,202001,WESTERN EUROPE-EU,SPAIN,HEATHROW,BARCELONA,56510,56510,0,54045,54045,0,4.561014
11/03/2020 11:02,202001,WESTERN EUROPE-EU,SPAIN,HEATHROW,BILBAO,0,0,0,7753,7753,0,-100
11/03/2020 11:02,202001,WESTERN EUROPE-EU,SPAIN,HEATHROW,MADRID,113056,113056,0,104954,104954,0,7.719572
11/03/2020 11:02,202001,WESTERN EUROPE-EU,SPAIN,HEATHROW,MALAGA,4738,4738,0,4045,4045,0,17.132262
11/03/2020 11:02,202001,WESTERN EUROPE-EU,SPAIN,HEATHROW,SANTIAGO DE COMPOSTELA (SPAIN),0,0,0,204,204,0,-100
11/03/2020 11:02,202001,WESTERN EUROPE-EU,SPAIN,HEATHROW,VALENCIA,3734,3734,0,0,0,0,0
11/03/2020 11:02,202001,WESTERN EUROPE-EU,SPAIN,LONDON CITY,IBIZA,3761,3761,0,3542,3542,0,6.182947
11/03/2020 11:02,202001,WESTERN EUROPE-EU,SPAIN,LONDON CITY,MALAGA,2171,2171,0,3231,3231,0,-32.80718
11/03/2020 11:02,202001,WESTERN EUROPE-EU,SPAIN,LONDON CITY,PALMA DE MALLORCA,1334,1334,0,1071,1071,0,24.556489
11/03/2020 11:02,202001,WESTERN EUROPE-EU,SPAIN,LUTON,ALICANTE,13185,13185,0,13669,13669,0,-3.540859
11/03/2020 11:02,202001,WESTERN EUROPE-EU,SPAIN,LUTON,BARCELONA,33707,33707,0,34762,34762,0,-3.034923
11/03/2020 11:02,202001,WESTERN EUROPE-EU,SPAIN,LUTON,CASTELLON COSTA AZAHAR,1797,1797,0,0,0,0,0
11/03/2020 11:02,202001,WESTERN EUROPE-EU,SPAIN,LUTON,CASTELLON DE LA PLANA AIRPORT,333,333,0,0,0,0,0
11/03/2020 11:02,202001,WESTERN EUROPE-EU,SPAIN,LUTON,MADRID,6737,6737,0,5706,5706,0,18.0687
11/03/2020 11:02,202001,WESTERN EUROPE-EU,SPAIN,LUTON,MALAGA,15955,15955,0,16186,16186,0,-1.427159
11/03/2020 11:02,202001,WESTERN EUROPE-EU,SPAIN,LUTON,MURCIA INTERNATIONAL,725,725,0,2176,2176,0,-66.681985
11/03/2020 11:02,202001,WESTERN EUROPE-EU,SPAIN,LUTON,MURCIA SAN JAVIER,0,0,0,1827,1827,0,-100
11/03/2020 11:02,202001,WESTERN EUROPE-EU,SPAIN,LUTON,PALMA DE MALLORCA,2689,2689,0,2306,2306,0,16.608846
11/03/2020 11:02,202001,WESTERN EUROPE-EU,SPAIN,LUTON,SEVILLE,6195,6195,0,2807,2807,0,120.698254
11/03/2020 11:02,202001,WESTERN EUROPE-EU,SPAIN,LUTON,VALENCIA,2520,2520,0,2691,2691,0,-6.354515
11/03/2020 11:02,202001,WESTERN EUROPE-EU,SPAIN,SOUTHEND,ALICANTE,10280,10280,0,4617,4617,0,122.655404
11/03/2020 11:02,202001,WESTERN EUROPE-EU,SPAIN,SOUTHEND,BARCELONA,852,852,0,1858,1858,0,-54.144241
11/03/2020 11:02,202001,WESTERN EUROPE-EU,SPAIN,SOUTHEND,BILBAO,3346,3346,0,0,0,0,0
11/03/2020 11:02,202001,WESTERN EUROPE-EU,SPAIN,SOUTHEND,MALAGA,9361,9361,0,4586,4586,0,104.121239
11/03/2020 11:02,202001,WESTERN EUROPE-EU,SPAIN,SOUTHEND,MURCIA INTERNATIONAL,2688,2688,0,1076,1076,0,149.814126
11/03/2020 11:02,202001,WESTERN EUROPE-EU,SPAIN,SOUTHEND,MURCIA SAN JAVIER,0,0,0,967,967,0,-100
11/03/2020 11:02,202001,WESTERN EUROPE-EU,SPAIN,STANSTED,ALICANTE,18353,18353,0,20708,20708,0,-11.372416
11/03/2020 11:02,202001,WESTERN EUROPE-EU,SPAIN,STANSTED,BARCELONA,46819,46819,0,43032,43032,0,8.800428
11/03/2020 11:02,202001,WESTERN EUROPE-EU,SPAIN,STANSTED,BILBAO,2572,2572,0,3059,3059,0,-15.920235
11/03/2020 11:02,202001,WESTERN EUROPE-EU,SPAIN,STANSTED,CASTELLON COSTA AZAHAR,1557,1557,0,2298,2298,0,-32.245431
11/03/2020 11:02,202001,WESTERN EUROPE-EU,SPAIN,STANSTED,CASTELLON DE LA PLANA AIRPORT,0,0,0,1220,1220,0,-100
11/03/2020 11:02,202001,WESTERN EUROPE-EU,SPAIN,STANSTED,JEREZ,2956,2956,0,2478,2478,0,19.28975
11/03/2020 11:02,202001,WESTERN EUROPE-EU,SPAIN,STANSTED,LIEIDA,0,0,0,414,414,0,-100
11/03/2020 11:02,202001,WESTERN EUROPE-EU,SPAIN,STANSTED,MADRID,41668,41668,0,39221,39221,0,6.239005
11/03/2020 11:02,202001,WESTERN EUROPE-EU,SPAIN,STANSTED,MALAGA,25200,25200,0,26396,26396,0,-4.53099
11/03/2020 11:02,202001,WESTERN EUROPE-EU,SPAIN,STANSTED,MURCIA INTERNATIONAL,5891,5891,0,3498,3498,0,68.41052
11/03/2020 11:02,202001,WESTERN EUROPE-EU,SPAIN,STANSTED,MURCIA SAN JAVIER,0,0,0,2778,2778,0,-100
11/03/2020 11:02,202001,WESTERN EUROPE-EU,SPAIN,STANSTED,PALMA DE MALLORCA,8664,8664,0,9744,9744,0,-11.083744
11/03/2020 11:02,202001,WESTERN EUROPE-EU,SPAIN,STANSTED,REUS,1181,1181,0,3158,3158,0,-62.602913
11/03/2020 11:02,202001,WESTERN EUROPE-EU,SPAIN,STANSTED,SANTANDER,7333,7333,0,6773,6773,0,8.268123
11/03/2020 11:02,202001,WESTERN EUROPE-EU,SPAIN,STANSTED,SANTIAGO DE COMPOSTELA (SPAIN),5309,5309,0,5282,5282,0,0.51117
11/03/2020 11:02,202001,WESTERN EUROPE-EU,SPAIN,STANSTED,SEVILLE,11128,11128,0,13706,13706,0,-18.809281
11/03/2020 11:02,202001,WESTERN EUROPE-EU,SPAIN,STANSTED,VALENCIA,12297,12297,0,12820,12820,0,-4.079563
11/03/2020 11:02,202001,WESTERN EUROPE-EU,SPAIN,STANSTED,ZARAGOZA,7844,7844,0,7636,7636,0,2.723939
11/03/2020 11:02,202001,WESTERN EUROPE-EU,SPAIN,ABERDEEN,ALICANTE,2803,2803,0,2575,2575,0,8.854369
11/03/2020 11:02,202001,WESTERN EUROPE-EU,SPAIN,BELFAST INTERNATIONAL,ALICANTE,5242,5242,0,8990,8990,0,-41.690768
11/03/2020 11:02,202001,WESTERN EUROPE-EU,SPAIN,BELFAST INTERNATIONAL,MALAGA,6690,6690,0,8916,8916,0,-24.966353
11/03/2020 11:02,202001,WESTERN EUROPE-EU,SPAIN,BIRMINGHAM,ALICANTE,19665,18237,1428,18709,16927,1782,5.10984
11/03/2020 11:02,202001,WESTERN EUROPE-EU,SPAIN,BIRMINGHAM,BARCELONA,16621,16621,0,14636,14636,0,13.562449
11/03/2020 11:02,202001,WESTERN EUROPE-EU,SPAIN,BIRMINGHAM,LIEIDA,0,0,0,473,0,473,-100
11/03/2020 11:02,202001,WESTERN EUROPE-EU,SPAIN,BIRMINGHAM,MADRID,8191,8191,0,8804,8804,0,-6.962744
11/03/2020 11:02,202001,WESTERN EUROPE-EU,SPAIN,BIRMINGHAM,MALAGA,16828,15266,1562,15450,14091,1359,8.919094
11/03/2020 11:02,202001,WESTERN EUROPE-EU,SPAIN,BIRMINGHAM,MURCIA INTERNATIONAL,4247,4105,142,1392,1392,0,205.100575
11/03/2020 11:02,202001,WESTERN EUROPE-EU,SPAIN,BIRMINGHAM,MURCIA SAN JAVIER,0,0,0,1556,1556,0,-100
11/03/2020 11:02,202001,WESTERN EUROPE-EU,SPAIN,BIRMINGHAM,PALMA DE MALLORCA,620,620,0,284,284,0,118.309859
11/03/2020 11:02,202001,WESTERN EUROPE-EU,SPAIN,BIRMINGHAM,REUS,0,0,0,161,0,161,-100
11/03/2020 11:02,202001,WESTERN EUROPE-EU,SPAIN,BIRMINGHAM,VALENCIA,40,40,0,0,0,0,0
11/03/2020 11:02,202001,WESTERN EUROPE-EU,SPAIN,BOURNEMOUTH,ALICANTE,4588,4588,0,4916,4916,0,-6.672091
11/03/2020 11:02,202001,WESTERN EUROPE-EU,SPAIN,BOURNEMOUTH,MALAGA,3371,3371,0,3666,3666,0,-8.046918
11/03/2020 11:02,202001,WESTERN EUROPE-EU,SPAIN,BRISTOL,ALICANTE,16720,16720,0,16570,16570,0,0.90525
11/03/2020 11:02,202001,WESTERN EUROPE-EU,SPAIN,BRISTOL,BARCELONA,11989,11989,0,10520,10520,0,13.963878
11/03/2020 11:02,202001,WESTERN EUROPE-EU,SPAIN,BRISTOL,BILBAO,2303,2303,0,2256,2256,0,2.083333
11/03/2020 11:02,202001,WESTERN EUROPE-EU,SPAIN,BRISTOL,LIEIDA,0,0,0,485,0,485,-100
11/03/2020 11:02,202001,WESTERN EUROPE-EU,SPAIN,BRISTOL,MADRID,6681,6681,0,6724,6724,0,-0.6395
11/03/2020 11:02,202001,WESTERN EUROPE-EU,SPAIN,BRISTOL,MALAGA,16457,16267,190,14177,13957,220,16.082387
11/03/2020 11:02,202001,WESTERN EUROPE-EU,SPAIN,BRISTOL,MURCIA INTERNATIONAL,3461,3461,0,1452,1452,0,138.360882
11/03/2020 11:02,202001,WESTERN EUROPE-EU,SPAIN,BRISTOL,MURCIA SAN JAVIER,0,0,0,1584,1584,0,-100
11/03/2020 11:02,202001,WESTERN EUROPE-EU,SPAIN,BRISTOL,PALMA DE MALLORCA,3268,3268,0,3349,3349,0,-2.418632
11/03/2020 11:02,202001,WESTERN EUROPE-EU,SPAIN,BRISTOL,REUS,0,0,0,174,0,174,-100
11/03/2020 11:02,202001,WESTERN EUROPE-EU,SPAIN,BRISTOL,SEVILLE,5178,5178,0,5873,5873,0,-11.833816
11/03/2020 11:02,202001,WESTERN EUROPE-EU,SPAIN,BRISTOL,VALENCIA,2644,2644,0,2366,2366,0,11.749789
11/03/2020 11:02,202001,WESTERN EUROPE-EU,SPAIN,CARDIFF WALES,ALICANTE,6870,3980,2890,6358,3154,3204,8.052847
11/03/2020 11:02,202001,WESTERN EUROPE-EU,SPAIN,CARDIFF WALES,MALAGA,2037,563,1474,3765,2384,1381,-45.896414
11/03/2020 11:02,202001,WESTERN EUROPE-EU,SPAIN,DONCASTER SHEFFIELD,ALICANTE,3064,0,3064,3889,447,3442,-21.21368
11/03/2020 11:02,202001,WESTERN EUROPE-EU,SPAIN,DONCASTER SHEFFIELD,MALAGA,1504,0,1504,1506,0,1506,-0.132802
11/03/2020 11:02,202001,WESTERN EUROPE-EU,SPAIN,EAST MIDLANDS INTERNATIONAL,ALICANTE,16569,15138,1431,17851,16050,1801,-7.18167
11/03/2020 11:02,202001,WESTERN EUROPE-EU,SPAIN,EAST MIDLANDS INTERNATIONAL,MALAGA,13286,11883,1403,11583,10238,1345,14.702581
11/03/2020 11:02,202001,WESTERN EUROPE-EU,SPAIN,EAST MIDLANDS INTERNATIONAL,MURCIA INTERNATIONAL,1572,1572,0,1492,1492,0,5.36193
11/03/2020 11:02,202001,WESTERN EUROPE-EU,SPAIN,EAST MIDLANDS INTERNATIONAL,MURCIA SAN JAVIER,0,0,0,2083,2083,0,-100
11/03/2020 11:02,202001,WESTERN EUROPE-EU,SPAIN,EAST MIDLANDS INTERNATIONAL,SEVILLE,0,0,0,2811,2811,0,-100
11/03/2020 11:02,202001,WESTERN EUROPE-EU,SPAIN,EDINBURGH,ALICANTE,13779,13779,0,13527,13527,0,1.862941
11/03/2020 11:02,202001,WESTERN EUROPE-EU,SPAIN,EDINBURGH,BARCELONA,9866,9866,0,9676,9676,0,1.963621
11/03/2020 11:02,202001,WESTERN EUROPE-EU,SPAIN,EDINBURGH,BILBAO,170,170,0,863,863,0,-80.301275
11/03/2020 11:02,202001,WESTERN EUROPE-EU,SPAIN,EDINBURGH,MADRID,8368,8368,0,8272,8272,0,1.160542
11/03/2020 11:02,202001,WESTERN EUROPE-EU,SPAIN,EDINBURGH,MALAGA,7590,7590,0,7211,7211,0,5.255859
11/03/2020 11:02,202001,WESTERN EUROPE-EU,SPAIN,EDINBURGH,SANTANDER,2874,2874,0,2615,2615,0,9.904398
11/03/2020 11:02,202001,WESTERN EUROPE-EU,SPAIN,EDINBURGH,SANTIAGO DE COMPOSTELA (SPAIN),185,185,0,0,0,0,0
11/03/2020 11:02,202001,WESTERN EUROPE-EU,SPAIN,EDINBURGH,SEVILLE,5568,5568,0,5682,5682,0,-2.006336
11/03/2020 11:02,202001,WESTERN EUROPE-EU,SPAIN,EDINBURGH,VALENCIA,0,0,0,4149,4149,0,-100
11/03/2020 11:02,202001,WESTERN EUROPE-EU,SPAIN,EXETER,ALICANTE,2887,2887,0,2055,2055,0,40.486618
11/03/2020 11:02,202001,WESTERN EUROPE-EU,SPAIN,EXETER,MALAGA,2872,2872,0,1402,1402,0,104.850214
11/03/2020 11:02,202001,WESTERN EUROPE-EU,SPAIN,GLASGOW,ALICANTE,11984,10503,1481,13317,11171,2146,-10.009762
11/03/2020 11:02,202001,WESTERN EUROPE-EU,SPAIN,GLASGOW,BARCELONA,2861,2861,0,2920,2920,0,-2.020548
11/03/2020 11:02,202001,WESTERN EUROPE-EU,SPAIN,GLASGOW,MALAGA,9574,9574,0,6340,6340,0,51.009464
11/03/2020 11:02,202001,WESTERN EUROPE-EU,SPAIN,LEEDS BRADFORD,ALICANTE,15135,15135,0,15042,15042,0,0.618269
11/03/2020 11:02,202001,WESTERN EUROPE-EU,SPAIN,LEEDS BRADFORD,BARCELONA,553,553,0,601,601,0,-7.986689
11/03/2020 11:02,202001,WESTERN EUROPE-EU,SPAIN,LEEDS BRADFORD,MALAGA,10761,10761,0,9918,9918,0,8.499698
11/03/2020 11:02,202001,WESTERN EUROPE-EU,SPAIN,LEEDS BRADFORD,MURCIA INTERNATIONAL,1301,1301,0,979,979,0,32.890705
11/03/2020 11:02,202001,WESTERN EUROPE-EU,SPAIN,LEEDS BRADFORD,MURCIA SAN JAVIER,0,0,0,1362,1362,0,-100
11/03/2020 11:02,202001,WESTERN EUROPE-EU,SPAIN,LEEDS BRADFORD,VALENCIA,144,144,0,0,0,0,0
11/03/2020 11:02,202001,WESTERN EUROPE-EU,SPAIN,LIVERPOOL (JOHN LENNON),ALICANTE,12761,12761,0,14670,14670,0,-13.012952
11/03/2020 11:02,202001,WESTERN EUROPE-EU,SPAIN,LIVERPOOL (JOHN LENNON),BARCELONA,8281,8281,0,10123,10123,0,-18.196187
11/03/2020 11:02,202001,WESTERN EUROPE-EU,SPAIN,LIVERPOOL (JOHN LENNON),MADRID,3934,3934,0,4377,4377,0,-10.121088
11/03/2020 11:02,202001,WESTERN EUROPE-EU,SPAIN,LIVERPOOL (JOHN LENNON),MALAGA,11915,11915,0,12415,12415,0,-4.027386
11/03/2020 11:02,202001,WESTERN EUROPE-EU,SPAIN,LIVERPOOL (JOHN LENNON),MURCIA INTERNATIONAL,327,327,0,139,139,0,135.251799
11/03/2020 11:02,202001,WESTERN EUROPE-EU,SPAIN,LIVERPOOL (JOHN LENNON),PALMA DE MALLORCA,290,290,0,2002,2002,0,-85.514486
11/03/2020 11:02,202001,WESTERN EUROPE-EU,SPAIN,MANCHESTER,ALICANTE,36564,33650,2914,37665,33282,4383,-2.923138
11/03/2020 11:02,202001,WESTERN EUROPE-EU,SPAIN,MANCHESTER,BARCELONA,29994,29994,0,23484,23484,0,27.721002
11/03/2020 11:02,202001,WESTERN EUROPE-EU,SPAIN,MANCHESTER,BILBAO,3728,3728,0,3304,3304,0,12.83293
11/03/2020 11:02,202001,WESTERN EUROPE-EU,SPAIN,MANCHESTER,GRANADA,870,870,0,2305,2305,0,-62.255965
11/03/2020 11:02,202001,WESTERN EUROPE-EU,SPAIN,MANCHESTER,LIEIDA,0,0,0,1621,0,1621,-100
11/03/2020 11:02,202001,WESTERN EUROPE-EU,SPAIN,MANCHESTER,MADRID,14406,14406,0,13001,13001,0,10.806861
11/03/2020 11:02,202001,WESTERN EUROPE-EU,SPAIN,MANCHESTER,MALAGA,30196,26637,3559,28945,25616,3329,4.32199
11/03/2020 11:02,202001,WESTERN EUROPE-EU,SPAIN,MANCHESTER,MURCIA INTERNATIONAL,4412,4412,0,2124,2124,0,107.721281
11/03/2020 11:02,202001,WESTERN EUROPE-EU,SPAIN,MANCHESTER,MURCIA SAN JAVIER,0,0,0,2336,2336,0,-100
11/03/2020 11:02,202001,WESTERN EUROPE-EU,SPAIN,MANCHESTER,PALMA DE MALLORCA,7349,7349,0,9157,9157,0,-19.744458
11/03/2020 11:02,202001,WESTERN EUROPE-EU,SPAIN,MANCHESTER,SEVILLE,5892,5892,0,2917,2917,0,101.988344
11/03/2020 11:02,202001,WESTERN EUROPE-EU,SPAIN,MANCHESTER,VALENCIA,3257,3257,0,2796,2796,0,16.48784
11/03/2020 11:02,202001,WESTERN EUROPE-EU,SPAIN,NEWCASTLE,ALICANTE,17888,17888,0,17700,17700,0,1.062147
11/03/2020 11:02,202001,WESTERN EUROPE-EU,SPAIN,NEWCASTLE,BARCELONA,3373,3373,0,3224,3224,0,4.621588
11/03/2020 11:02,202001,WESTERN EUROPE-EU,SPAIN,NEWCASTLE,MALAGA,11152,11152,0,10904,10904,0,2.274395
11/03/2020 11:02,202001,WESTERN EUROPE-EU,SPAIN,NEWQUAY,ALICANTE,2766,2766,0,2495,2495,0,10.861723
11/03/2020 11:02,202001,WESTERN EUROPE-EU,SPAIN,NORWICH,ALICANTE,0,0,0,320,320,0,-100
11/03/2020 11:02,202001,WESTERN EUROPE-EU,SPAIN,NORWICH,MALAGA,0,0,0,179,179,0,-100
11/03/2020 11:02,202001,WESTERN EUROPE-EU,SPAIN,PRESTWICK,ALICANTE,5212,5212,0,3886,3886,0,34.122491
11/03/2020 11:02,202001,WESTERN EUROPE-EU,SPAIN,PRESTWICK,MALAGA,3115,3115,0,2981,2981,0,4.495136
11/03/2020 11:02,202001,WESTERN EUROPE-EU,SPAIN,PRESTWICK,VALENCIA,212,212,0,0,0,0,0
11/03/2020 11:02,202001,WESTERN EUROPE-EU,SPAIN,SOUTHAMPTON,ALICANTE,0,0,0,1037,1037,0,-100
11/03/2020 11:02,202001,WESTERN EUROPE-EU,SPAIN(CANARY ISLANDS),GATWICK,ARRECIFE,21787,18171,3616,25841,20237,5604,-15.688247
11/03/2020 11:02,202001,WESTERN EUROPE-EU,SPAIN(CANARY ISLANDS),GATWICK,FUERTEVENTURA,10189,7202,2987,13306,9496,3810,-23.425522
11/03/2020 11:02,202001,WESTERN EUROPE-EU,SPAIN(CANARY ISLANDS),GATWICK,LAS PALMAS,20111,14378,5733,19248,13340,5908,4.483583
11/03/2020 11:02,202001,WESTERN EUROPE-EU,SPAIN(CANARY ISLANDS),GATWICK,SANTA CRUZ DE LA PALMA,4341,2750,1591,4176,2710,1466,3.951149
11/03/2020 11:02,202001,WESTERN EUROPE-EU,SPAIN(CANARY ISLANDS),GATWICK,TENERIFE (SURREINA SOFIA),50214,40383,9831,53489,43249,10240,-6.122754
11/03/2020 11:02,202001,WESTERN EUROPE-EU,SPAIN(CANARY ISLANDS),HEATHROW,LAS PALMAS,0,0,0,1986,1986,0,-100
11/03/2020 11:02,202001,WESTERN EUROPE-EU,SPAIN(CANARY ISLANDS),HEATHROW,TENERIFE (SURREINA SOFIA),1103,1103,0,872,872,0,26.490826
11/03/2020 11:02,202001,WESTERN EUROPE-EU,SPAIN(CANARY ISLANDS),LUTON,ARRECIFE,6108,5920,188,8000,6582,1418,-23.65
11/03/2020 11:02,202001,WESTERN EUROPE-EU,SPAIN(CANARY ISLANDS),LUTON,FUERTEVENTURA,0,0,0,2610,2610,0,-100
11/03/2020 11:02,202001,WESTERN EUROPE-EU,SPAIN(CANARY ISLANDS),LUTON,LAS PALMAS,193,0,193,187,0,187,3.208556
11/03/2020 11:02,202001,WESTERN EUROPE-EU,SPAIN(CANARY ISLANDS),LUTON,TENERIFE (SURREINA SOFIA),14285,12540,1745,10347,7538,2809,38.059341
11/03/2020 11:02,202001,WESTERN EUROPE-EU,SPAIN(CANARY ISLANDS),SOUTHEND,ARRECIFE,2927,2927,0,2549,2549,0,14.829345
11/03/2020 11:02,202001,WESTERN EUROPE-EU,SPAIN(CANARY ISLANDS),SOUTHEND,TENERIFE (SURREINA SOFIA),2614,2614,0,2974,2974,0,-12.104909
11/03/2020 11:02,202001,WESTERN EUROPE-EU,SPAIN(CANARY ISLANDS),STANSTED,ARRECIFE,16693,16503,190,15639,13932,1707,6.739561
11/03/2020 11:02,202001,WESTERN EUROPE-EU,SPAIN(CANARY ISLANDS),STANSTED,FUERTEVENTURA,12793,12793,0,11070,9587,1483,15.564589
11/03/2020 11:02,202001,WESTERN EUROPE-EU,SPAIN(CANARY ISLANDS),STANSTED,LAS PALMAS,15446,13967,1479,14678,13325,1353,5.23232
11/03/2020 11:02,202001,WESTERN EUROPE-EU,SPAIN(CANARY ISLANDS),STANSTED,TENERIFE (SURREINA SOFIA),28810,26694,2116,30003,27000,3003,-3.976269
11/03/2020 11:02,202001,WESTERN EUROPE-EU,SPAIN(CANARY ISLANDS),ABERDEEN,TENERIFE (SURREINA SOFIA),3357,0,3357,3374,0,3374,-0.503853
11/03/2020 11:02,202001,WESTERN EUROPE-EU,SPAIN(CANARY ISLANDS),BELFAST INTERNATIONAL,ARRECIFE,6910,6910,0,11243,9145,2098,-38.539536
11/03/2020 11:02,202001,WESTERN EUROPE-EU,SPAIN(CANARY ISLANDS),BELFAST INTERNATIONAL,FUERTEVENTURA,4216,4216,0,4280,4280,0,-1.495327
11/03/2020 11:02,202001,WESTERN EUROPE-EU,SPAIN(CANARY ISLANDS),BELFAST INTERNATIONAL,LAS PALMAS,1523,1523,0,1464,1464,0,4.030055
11/03/2020 11:02,202001,WESTERN EUROPE-EU,SPAIN(CANARY ISLANDS),BELFAST INTERNATIONAL,TENERIFE (SURREINA SOFIA),6917,6917,0,8638,6648,1990,-19.923593
11/03/2020 11:02,202001,WESTERN EUROPE-EU,SPAIN(CANARY ISLANDS),BIRMINGHAM,ARRECIFE,17812,13913,3899,18164,13829,4335,-1.937899
11/03/2020 11:02,202001,WESTERN EUROPE-EU,SPAIN(CANARY ISLANDS),BIRMINGHAM,FUERTEVENTURA,9806,9404,402,10528,7107,3421,-6.857903
11/03/2020 11:02,202001,WESTERN EUROPE-EU,SPAIN(CANARY ISLANDS),BIRMINGHAM,LAS PALMAS,11104,8498,2606,8612,5565,3047,28.936368
11/03/2020 11:02,202001,WESTERN EUROPE-EU,SPAIN(CANARY ISLANDS),BIRMINGHAM,TENERIFE (SURREINA SOFIA),30668,23139,7529,28094,21632,6462,9.162099
11/03/2020 11:02,202001,WESTERN EUROPE-EU,SPAIN(CANARY ISLANDS),BOURNEMOUTH,ARRECIFE,3157,0,3157,3251,0,3251,-2.891418
11/03/2020 11:02,202001,WESTERN EUROPE-EU,SPAIN(CANARY ISLANDS),BOURNEMOUTH,LAS PALMAS,2704,1318,1386,1307,0,1307,106.885998
11/03/2020 11:02,202001,WESTERN EUROPE-EU,SPAIN(CANARY ISLANDS),BOURNEMOUTH,TENERIFE (SURREINA SOFIA),4842,1533,3309,4930,1688,3242,-1.78499
11/03/2020 11:02,202001,WESTERN EUROPE-EU,SPAIN(CANARY ISLANDS),BRISTOL,ARRECIFE,11394,8023,3371,14729,7271,7458,-22.642406
11/03/2020 11:02,202001,WESTERN EUROPE-EU,SPAIN(CANARY ISLANDS),BRISTOL,FUERTEVENTURA,4705,3177,1528,6619,3119,3500,-28.916755
11/03/2020 11:02,202001,WESTERN EUROPE-EU,SPAIN(CANARY ISLANDS),BRISTOL,LAS PALMAS,6319,4856,1463,5885,4330,1555,7.374681
11/03/2020 11:02,202001,WESTERN EUROPE-EU,SPAIN(CANARY ISLANDS),BRISTOL,TENERIFE (SURREINA SOFIA),18532,13689,4843,18419,11233,7186,0.613497
11/03/2020 11:02,202001,WESTERN EUROPE-EU,SPAIN(CANARY ISLANDS),CARDIFF WALES,ARRECIFE,3336,0,3336,3282,0,3282,1.645338
11/03/2020 11:02,202001,WESTERN EUROPE-EU,SPAIN(CANARY ISLANDS),CARDIFF WALES,LAS PALMAS,1483,0,1483,1418,0,1418,4.583921
11/03/2020 11:02,202001,WESTERN EUROPE-EU,SPAIN(CANARY ISLANDS),CARDIFF WALES,TENERIFE (SURREINA SOFIA),5342,578,4764,7379,2841,4538,-27.605367
11/03/2020 11:02,202001,WESTERN EUROPE-EU,SPAIN(CANARY ISLANDS),DONCASTER SHEFFIELD,ARRECIFE,3512,0,3512,3401,0,3401,3.263746
11/03/2020 11:02,202001,WESTERN EUROPE-EU,SPAIN(CANARY ISLANDS),DONCASTER SHEFFIELD,LAS PALMAS,1538,0,1538,1449,0,1449,6.142167
11/03/2020 11:02,202001,WESTERN EUROPE-EU,SPAIN(CANARY ISLANDS),DONCASTER SHEFFIELD,TENERIFE (SURREINA SOFIA),4971,0,4971,4822,0,4822,3.090004
11/03/2020 11:02,202001,WESTERN EUROPE-EU,SPAIN(CANARY ISLANDS),EAST MIDLANDS INTERNATIONAL,ARRECIFE,14758,12895,1863,16471,14692,1779,-10.400097
11/03/2020 11:02,202001,WESTERN EUROPE-EU,SPAIN(CANARY ISLANDS),EAST MIDLANDS INTERNATIONAL,FUERTEVENTURA,8290,6423,1867,9178,7411,1767,-9.675311
11/03/2020 11:02,202001,WESTERN EUROPE-EU,SPAIN(CANARY ISLANDS),EAST MIDLANDS INTERNATIONAL,LAS PALMAS,6295,6295,0,7333,6130,1203,-14.155189
11/03/2020 11:02,202001,WESTERN EUROPE-EU,SPAIN(CANARY ISLANDS),EAST MIDLANDS INTERNATIONAL,TENERIFE (SURREINA SOFIA),23558,18740,4818,28333,23844,4489,-16.853139
11/03/2020 11:02,202001,WESTERN EUROPE-EU,SPAIN(CANARY ISLANDS),EDINBURGH,ARRECIFE,9224,7326,1898,10034,8198,1836,-8.072553
11/03/2020 11:02,202001,WESTERN EUROPE-EU,SPAIN(CANARY ISLANDS),EDINBURGH,FUERTEVENTURA,5148,5148,0,5891,5891,0,-12.61246
11/03/2020 11:02,202001,WESTERN EUROPE-EU,SPAIN(CANARY ISLANDS),EDINBURGH,LAS PALMAS,4949,4949,0,7343,6033,1310,-32.602479
11/03/2020 11:02,202001,WESTERN EUROPE-EU,SPAIN(CANARY ISLANDS),EDINBURGH,TENERIFE (SURREINA SOFIA),23565,20041,3524,19820,16541,3279,18.895055
11/03/2020 11:02,202001,WESTERN EUROPE-EU,SPAIN(CANARY ISLANDS),EXETER,ARRECIFE,3310,0,3310,3250,0,3250,1.846154
11/03/2020 11:02,202001,WESTERN EUROPE-EU,SPAIN(CANARY ISLANDS),EXETER,LAS PALMAS,1434,0,1434,1339,0,1339,7.094847
11/03/2020 11:02,202001,WESTERN EUROPE-EU,SPAIN(CANARY ISLANDS),EXETER,TENERIFE (SURREINA SOFIA),5143,0,5143,4700,0,4700,9.425532
11/03/2020 11:02,202001,WESTERN EUROPE-EU,SPAIN(CANARY ISLANDS),GLASGOW,ARRECIFE,10601,8700,1901,10630,9564,1066,-0.272813
11/03/2020 11:02,202001,WESTERN EUROPE-EU,SPAIN(CANARY ISLANDS),GLASGOW,FUERTEVENTURA,4975,4975,0,7325,7325,0,-32.081911
11/03/2020 11:02,202001,WESTERN EUROPE-EU,SPAIN(CANARY ISLANDS),GLASGOW,LAS PALMAS,7969,6486,1483,7275,6250,1025,9.539519
11/03/2020 11:02,202001,WESTERN EUROPE-EU,SPAIN(CANARY ISLANDS),GLASGOW,TENERIFE (SURREINA SOFIA),16069,13477,2592,22671,19442,3229,-29.120903
11/03/2020 11:02,202001,WESTERN EUROPE-EU,SPAIN(CANARY ISLANDS),LEEDS BRADFORD,ARRECIFE,8464,8464,0,9796,9796,0,-13.597387
11/03/2020 11:02,202001,WESTERN EUROPE-EU,SPAIN(CANARY ISLANDS),LEEDS BRADFORD,FUERTEVENTURA,3082,3082,0,5950,5950,0,-48.201681
11/03/2020 11:02,202001,WESTERN EUROPE-EU,SPAIN(CANARY ISLANDS),LEEDS BRADFORD,LAS PALMAS,4911,4911,0,5425,5425,0,-9.474654
11/03/2020 11:02,202001,WESTERN EUROPE-EU,SPAIN(CANARY ISLANDS),LEEDS BRADFORD,TENERIFE (SURREINA SOFIA),16197,16197,0,15183,15183,0,6.678522
11/03/2020 11:02,202001,WESTERN EUROPE-EU,SPAIN(CANARY ISLANDS),LIVERPOOL (JOHN LENNON),ARRECIFE,6048,6048,0,5854,5854,0,3.313973
11/03/2020 11:02,202001,WESTERN EUROPE-EU,SPAIN(CANARY ISLANDS),LIVERPOOL (JOHN LENNON),FUERTEVENTURA,3593,3593,0,3935,3935,0,-8.691233
11/03/2020 11:02,202001,WESTERN EUROPE-EU,SPAIN(CANARY ISLANDS),LIVERPOOL (JOHN LENNON),LAS PALMAS,0,0,0,74,74,0,-100
11/03/2020 11:02,202001,WESTERN EUROPE-EU,SPAIN(CANARY ISLANDS),LIVERPOOL (JOHN LENNON),TENERIFE (SURREINA SOFIA),3043,3043,0,1927,1927,0,57.913856
11/03/2020 11:02,202001,WESTERN EUROPE-EU,SPAIN(CANARY ISLANDS),MANCHESTER,ARRECIFE,31313,26131,5182,35713,28853,6860,-12.320444
11/03/2020 11:02,202001,WESTERN EUROPE-EU,SPAIN(CANARY ISLANDS),MANCHESTER,FUERTEVENTURA,15546,10723,4823,18255,14400,3855,-14.83977
11/03/2020 11:02,202001,WESTERN EUROPE-EU,SPAIN(CANARY ISLANDS),MANCHESTER,LAS PALMAS,21902,15149,6753,22020,16062,5958,-0.535876
11/03/2020 11:02,202001,WESTERN EUROPE-EU,SPAIN(CANARY ISLANDS),MANCHESTER,SANTA CRUZ DE LA PALMA,1675,0,1675,1882,0,1882,-10.998937
11/03/2020 11:02,202001,WESTERN EUROPE-EU,SPAIN(CANARY ISLANDS),MANCHESTER,TENERIFE (SURREINA SOFIA),66500,52654,13846,67317,54850,12467,-1.213661
11/03/2020 11:02,202001,WESTERN EUROPE-EU,SPAIN(CANARY ISLANDS),NEWCASTLE,ARRECIFE,8937,8937,0,11722,11722,0,-23.758744
11/03/2020 11:02,202001,WESTERN EUROPE-EU,SPAIN(CANARY ISLANDS),NEWCASTLE,FUERTEVENTURA,3259,3259,0,3372,3372,0,-3.351127
11/03/2020 11:02,202001,WESTERN EUROPE-EU,SPAIN(CANARY ISLANDS),NEWCASTLE,LAS PALMAS,4816,4816,0,4381,4381,0,9.92924
11/03/2020 11:02,202001,WESTERN EUROPE-EU,SPAIN(CANARY ISLANDS),NEWCASTLE,TENERIFE (SURREINA SOFIA),17726,17726,0,21518,21518,0,-17.622456
11/03/2020 11:02,202001,WESTERN EUROPE-EU,SPAIN(CANARY ISLANDS),NORWICH,TENERIFE (SURREINA SOFIA),1693,0,1693,1822,0,1822,-7.080132
11/03/2020 11:02,202001,WESTERN EUROPE-EU,SPAIN(CANARY ISLANDS),PRESTWICK,ARRECIFE,2731,2731,0,2667,2667,0,2.3997
11/03/2020 11:02,202001,WESTERN EUROPE-EU,SPAIN(CANARY ISLANDS),PRESTWICK,FUERTEVENTURA,0,0,0,1163,1163,0,-100
11/03/2020 11:02,202001,WESTERN EUROPE-EU,SPAIN(CANARY ISLANDS),PRESTWICK,TENERIFE (SURREINA SOFIA),3989,3989,0,6079,6079,0,-34.380655
11/03/2020 11:02,202001,WESTERN EUROPE-EU,SWEDEN,GATWICK,GOTEBORG (LANDVETTER),10215,10215,0,13474,13474,0,-24.187324
11/03/2020 11:02,202001,WESTERN EUROPE-EU,SWEDEN,GATWICK,OSTERSUND / FROSON,1676,1676,0,2039,2039,0,-17.802845
11/03/2020 11:02,202001,WESTERN EUROPE-EU,SWEDEN,GATWICK,STOCKHOLM (ARLANDA),28685,28685,0,35957,35957,0,-20.224157
11/03/2020 11:02,202001,WESTERN EUROPE-EU,SWEDEN,HEATHROW,GOTEBORG (LANDVETTER),19141,19141,0,17083,17083,0,12.047064
11/03/2020 11:02,202001,WESTERN EUROPE-EU,SWEDEN,HEATHROW,KIRUNA,422,0,422,487,0,487,-13.347023
11/03/2020 11:02,202001,WESTERN EUROPE-EU,SWEDEN,HEATHROW,STOCKHOLM (ARLANDA),67732,67732,0,67007,67007,0,1.081977
11/03/2020 11:02,202001,WESTERN EUROPE-EU,SWEDEN,LUTON,STOCKHOLM (ARLANDA),0,0,0,2122,2122,0,-100
11/03/2020 11:02,202001,WESTERN EUROPE-EU,SWEDEN,STANSTED,GOTEBORG (LANDVETTER),12514,12514,0,11679,11679,0,7.149585
11/03/2020 11:02,202001,WESTERN EUROPE-EU,SWEDEN,STANSTED,STOCKHOLM (ARLANDA),0,0,0,909,0,909,-100
11/03/2020 11:02,202001,WESTERN EUROPE-EU,SWEDEN,STANSTED,STOCKHOLM (SKAVSTA),15127,15127,0,18836,18836,0,-19.691017
11/03/2020 11:02,202001,WESTERN EUROPE-EU,SWEDEN,STANSTED,VASTERAS,4700,4700,0,5183,5183,0,-9.318927
11/03/2020 11:02,202001,WESTERN EUROPE-EU,SWEDEN,BELFAST INTERNATIONAL,UMEA,0,0,0,213,0,213,-100
11/03/2020 11:02,202001,WESTERN EUROPE-EU,SWEDEN,BIRMINGHAM,STOCKHOLM (ARLANDA),149,149,0,473,199,274,-68.498943
11/03/2020 11:02,202001,WESTERN EUROPE-EU,SWEDEN,BRISTOL,OSTERSUND / FROSON,0,0,0,328,328,0,-100
11/03/2020 11:02,202001,WESTERN EUROPE-EU,SWEDEN,BRISTOL,STOCKHOLM (ARLANDA),0,0,0,513,513,0,-100
11/03/2020 11:02,202001,WESTERN EUROPE-EU,SWEDEN,EDINBURGH,GOTEBORG (LANDVETTER),2502,2502,0,2206,2206,0,13.417951
11/03/2020 11:02,202001,WESTERN EUROPE-EU,SWEDEN,EDINBURGH,STOCKHOLM (ARLANDA),3205,3205,0,4706,4706,0,-31.895453
11/03/2020 11:02,202001,WESTERN EUROPE-EU,SWEDEN,EDINBURGH,STOCKHOLM (SKAVSTA),0,0,0,2291,2291,0,-100
11/03/2020 11:02,202001,WESTERN EUROPE-EU,SWEDEN,MANCHESTER,GOTEBORG (LANDVETTER),2760,2760,0,245,245,0,1026.530612
11/03/2020 11:02,202001,WESTERN EUROPE-EU,SWEDEN,MANCHESTER,STOCKHOLM (ARLANDA),10241,10241,0,10105,9832,273,1.345868
11/03/2020 11:02,202001,WESTERN EUROPE-OTHER,BOSNIA-HERZEGOVINA,LUTON,SARAJEVO,538,538,0,0,0,0,0
11/03/2020 11:02,202001,WESTERN EUROPE-OTHER,FAROE ISLANDS,EDINBURGH,VAGAR,502,502,0,131,131,0,283.206107
11/03/2020 11:02,202001,WESTERN EUROPE-OTHER,ICELAND,GATWICK,KEFLAVIK,20638,17558,3080,36308,33045,3263,-43.158533
11/03/2020 11:02,202001,WESTERN EUROPE-OTHER,ICELAND,HEATHROW,KEFLAVIK,23041,23041,0,23954,23954,0,-3.811472
11/03/2020 11:02,202001,WESTERN EUROPE-OTHER,ICELAND,LONDON CITY,KEFLAVIK,0,0,0,1013,1013,0,-100
11/03/2020 11:02,202001,WESTERN EUROPE-OTHER,ICELAND,LUTON,KEFLAVIK,25832,25832,0,26843,26843,0,-3.766345
11/03/2020 11:02,202001,WESTERN EUROPE-OTHER,ICELAND,STANSTED,KEFLAVIK,0,0,0,3825,3825,0,-100
11/03/2020 11:02,202001,WESTERN EUROPE-OTHER,ICELAND,ABERDEEN,KEFLAVIK,0,0,0,1,1,0,-100
11/03/2020 11:02,202001,WESTERN EUROPE-OTHER,ICELAND,BELFAST INTERNATIONAL,KEFLAVIK,2943,2943,0,2171,2171,0,35.55965
11/03/2020 11:02,202001,WESTERN EUROPE-OTHER,ICELAND,BOURNEMOUTH,AKUREYRI,0,0,0,208,0,208,-100
11/03/2020 11:02,202001,WESTERN EUROPE-OTHER,ICELAND,BRISTOL,KEFLAVIK,3535,2980,555,3377,3377,0,4.678709
11/03/2020 11:02,202001,WESTERN EUROPE-OTHER,ICELAND,CARDIFF WALES,AKUREYRI,0,0,0,266,0,266,-100
11/03/2020 11:02,202001,WESTERN EUROPE-OTHER,ICELAND,CITY OF DERRY (EGLINTON),AKUREYRI,0,0,0,366,0,366,-100
11/03/2020 11:02,202001,WESTERN EUROPE-OTHER,ICELAND,EAST MIDLANDS INTERNATIONAL,KEFLAVIK,0,0,0,540,0,540,-100
11/03/2020 11:02,202001,WESTERN EUROPE-OTHER,ICELAND,EDINBURGH,KEFLAVIK,5894,5894,0,5853,5853,0,0.700495
11/03/2020 11:02,202001,WESTERN EUROPE-OTHER,ICELAND,GLASGOW,KEFLAVIK,5402,5402,0,5970,5970,0,-9.514238
11/03/2020 11:02,202001,WESTERN EUROPE-OTHER,ICELAND,HUMBERSIDE,AKUREYRI,0,0,0,304,0,304,-100
11/03/2020 11:02,202001,WESTERN EUROPE-OTHER,ICELAND,LEEDS BRADFORD,AKUREYRI,0,0,0,144,0,144,-100
11/03/2020 11:02,202001,WESTERN EUROPE-OTHER,ICELAND,MANCHESTER,KEFLAVIK,22681,19396,3285,23958,20740,3218,-5.330161
11/03/2020 11:02,202001,WESTERN EUROPE-OTHER,ICELAND,NEWCASTLE,AKUREYRI,0,0,0,388,388,0,-100
11/03/2020 11:02,202001,WESTERN EUROPE-OTHER,ICELAND,NEWQUAY,AKUREYRI,0,0,0,316,0,316,-100
11/03/2020 11:02,202001,WESTERN EUROPE-OTHER,ICELAND,NORWICH,AKUREYRI,0,0,0,294,0,294,-100
11/03/2020 11:02,202001,WESTERN EUROPE-OTHER,KOSOVO,LUTON,PRISTINA,5561,5561,0,6193,6193,0,-10.20507
11/03/2020 11:02,202001,WESTERN EUROPE-OTHER,MACEDONIA,LUTON,OHRID,2003,2003,0,0,0,0,0
11/03/2020 11:02,202001,WESTERN EUROPE-OTHER,MACEDONIA,LUTON,SKOPJE,4182,4182,0,5067,5067,0,-17.465956
11/03/2020 11:02,202001,WESTERN EUROPE-OTHER,NORWAY,GATWICK,BERGEN,13661,13517,144,15029,14724,305,-9.102402
11/03/2020 11:02,202001,WESTERN EUROPE-OTHER,NORWAY,GATWICK,OSLO (GARDERMOEN),32629,32629,0,35587,35587,0,-8.312024
11/03/2020 11:02,202001,WESTERN EUROPE-OTHER,NORWAY,GATWICK,STAVANGER,5783,5783,0,6038,6038,0,-4.223253
11/03/2020 11:02,202001,WESTERN EUROPE-OTHER,NORWAY,GATWICK,TROMSOE,5885,5885,0,5093,5093,0,15.550756
11/03/2020 11:02,202001,WESTERN EUROPE-OTHER,NORWAY,GATWICK,TRONDHEIM (VAERNES),3146,3146,0,5128,5128,0,-38.650546
11/03/2020 11:02,202001,WESTERN EUROPE-OTHER,NORWAY,HEATHROW,OSLO (GARDERMOEN),47716,47716,0,45713,45713,0,4.381686
11/03/2020 11:02,202001,WESTERN EUROPE-OTHER,NORWAY,HEATHROW,STAVANGER,4250,4250,0,5354,5354,0,-20.620097
11/03/2020 11:02,202001,WESTERN EUROPE-OTHER,NORWAY,LUTON,BERGEN,4457,4457,0,0,0,0,0
11/03/2020 11:02,202001,WESTERN EUROPE-OTHER,NORWAY,LUTON,OSLO (GARDERMOEN),6274,6274,0,0,0,0,0
11/03/2020 11:02,202001,WESTERN EUROPE-OTHER,NORWAY,LUTON,STAVANGER,2074,2074,0,162,162,0,1180.246914
11/03/2020 11:02,202001,WESTERN EUROPE-OTHER,NORWAY,LUTON,TROMSOE,3552,3552,0,2395,2395,0,48.308977
11/03/2020 11:02,202001,WESTERN EUROPE-OTHER,NORWAY,STANSTED,KRISTIANSAND (KJEVIK),1392,1392,0,1404,1404,0,-0.854701
11/03/2020 11:02,202001,WESTERN EUROPE-OTHER,NORWAY,STANSTED,OSLO (GARDERMOEN),23524,23524,0,25231,25231,0,-6.765487
11/03/2020 11:02,202001,WESTERN EUROPE-OTHER,NORWAY,STANSTED,SANDEFJORD(TORP),2671,2671,0,3397,3397,0,-21.371799
11/03/2020 11:02,202001,WESTERN EUROPE-OTHER,NORWAY,ABERDEEN,BERGEN,2940,2940,0,2761,2761,0,6.483158
11/03/2020 11:02,202001,WESTERN EUROPE-OTHER,NORWAY,ABERDEEN,OSLO (GARDERMOEN),896,896,0,1486,1486,0,-39.703903
11/03/2020 11:02,202001,WESTERN EUROPE-OTHER,NORWAY,ABERDEEN,STAVANGER,7710,7710,0,7040,7040,0,9.517045
11/03/2020 11:02,202001,WESTERN EUROPE-OTHER,NORWAY,BIRMINGHAM,OSLO (GARDERMOEN),183,183,0,0,0,0,0
11/03/2020 11:02,202001,WESTERN EUROPE-OTHER,NORWAY,BOURNEMOUTH,BERGEN,122,0,122,0,0,0,0
11/03/2020 11:02,202001,WESTERN EUROPE-OTHER,NORWAY,BRISTOL,BERGEN,134,0,134,176,0,176,-23.863636
11/03/2020 11:02,202001,WESTERN EUROPE-OTHER,NORWAY,BRISTOL,OSLO (GARDERMOEN),0,0,0,240,240,0,-100
11/03/2020 11:02,202001,WESTERN EUROPE-OTHER,NORWAY,EDINBURGH,BERGEN,220,220,0,0,0,0,0
11/03/2020 11:02,202001,WESTERN EUROPE-OTHER,NORWAY,EDINBURGH,OSLO (GARDERMOEN),8102,8102,0,8543,8543,0,-5.162121
11/03/2020 11:02,202001,WESTERN EUROPE-OTHER,NORWAY,EDINBURGH,STAVANGER,558,558,0,0,0,0,0
11/03/2020 11:02,202001,WESTERN EUROPE-OTHER,NORWAY,EXETER,BARDUFOSS,0,0,0,231,0,231,-100
11/03/2020 11:02,202001,WESTERN EUROPE-OTHER,NORWAY,INVERNESS,BERGEN,0,0,0,51,51,0,-100
11/03/2020 11:02,202001,WESTERN EUROPE-OTHER,NORWAY,LIVERPOOL (JOHN LENNON),BERGEN,535,535,0,276,276,0,93.84058
11/03/2020 11:02,202001,WESTERN EUROPE-OTHER,NORWAY,LIVERPOOL (JOHN LENNON),OSLO (GARDERMOEN),926,0,926,0,0,0,0
11/03/2020 11:02,202001,WESTERN EUROPE-OTHER,NORWAY,MANCHESTER,BERGEN,2474,2214,260,447,125,322,453.467562
11/03/2020 11:02,202001,WESTERN EUROPE-OTHER,NORWAY,MANCHESTER,OSLO (GARDERMOEN),8665,8665,0,7996,7996,0,8.366683
11/03/2020 11:02,202001,WESTERN EUROPE-OTHER,NORWAY,MANCHESTER,SANDEFJORD(TORP),5819,5819,0,5038,5038,0,15.502183
11/03/2020 11:02,202001,WESTERN EUROPE-OTHER,NORWAY,MANCHESTER,STAVANGER,1958,1958,0,2312,2312,0,-15.311419
11/03/2020 11:02,202001,WESTERN EUROPE-OTHER,NORWAY,NEWCASTLE,STAVANGER,811,811,0,786,786,0,3.180662
11/03/2020 11:02,202001,WESTERN EUROPE-OTHER,NORWAY,SUMBURGH,BERGEN,45,45,0,0,0,0,0
11/03/2020 11:02,202001,WESTERN EUROPE-OTHER,REPUBLIC OF MONTENEGRO,STANSTED,PODGORICA,3119,3119,0,3450,3450,0,-9.594203
11/03/2020 11:02,202001,WESTERN EUROPE-OTHER,REPUBLIC OF SERBIA,HEATHROW,BELGRADE,6990,6990,0,5927,5927,0,17.934874
11/03/2020 11:02,202001,WESTERN EUROPE-OTHER,REPUBLIC OF SERBIA,LUTON,BELGRADE,5443,5443,0,4647,4647,0,17.129331
11/03/2020 11:02,202001,WESTERN EUROPE-OTHER,SWITZERLAND,GATWICK,BALE MULHOUSE,19477,19477,0,18750,18750,0,3.877333
11/03/2020 11:02,202001,WESTERN EUROPE-OTHER,SWITZERLAND,GATWICK,GENEVA,107123,105737,1386,102969,99330,3639,4.034224
11/03/2020 11:02,202001,WESTERN EUROPE-OTHER,SWITZERLAND,GATWICK,ZURICH,11367,11367,0,11885,11885,0,-4.358435
11/03/2020 11:02,202001,WESTERN EUROPE-OTHER,SWITZERLAND,HEATHROW,BALE MULHOUSE,21471,21471,0,19667,19667,0,9.172726
11/03/2020 11:02,202001,WESTERN EUROPE-OTHER,SWITZERLAND,HEATHROW,GENEVA,103429,103429,0,97254,97254,0,6.349353
11/03/2020 11:02,202001,WESTERN EUROPE-OTHER,SWITZERLAND,HEATHROW,ZURICH,98442,98442,0,90055,90055,0,9.313197
11/03/2020 11:02,202001,WESTERN EUROPE-OTHER,SWITZERLAND,LONDON CITY,GENEVA,14220,14220,0,18949,18949,0,-24.956462
11/03/2020 11:02,202001,WESTERN EUROPE-OTHER,SWITZERLAND,LONDON CITY,ZURICH,33635,33635,0,34845,34845,0,-3.472521
11/03/2020 11:02,202001,WESTERN EUROPE-OTHER,SWITZERLAND,LUTON,BALE MULHOUSE,3882,3882,0,3175,3175,0,22.267717
11/03/2020 11:02,202001,WESTERN EUROPE-OTHER,SWITZERLAND,LUTON,GENEVA,46914,46914,0,44831,44831,0,4.646338
11/03/2020 11:02,202001,WESTERN EUROPE-OTHER,SWITZERLAND,LUTON,ZURICH,9638,9638,0,9689,9689,0,-0.52637
11/03/2020 11:02,202001,WESTERN EUROPE-OTHER,SWITZERLAND,SOUTHEND,GENEVA,6790,6790,0,6203,6203,0,9.463163
11/03/2020 11:02,202001,WESTERN EUROPE-OTHER,SWITZERLAND,STANSTED,GENEVA,22334,22334,0,19117,19117,0,16.827954
11/03/2020 11:02,202001,WESTERN EUROPE-OTHER,SWITZERLAND,ABERDEEN,GENEVA,1235,1235,0,1117,1117,0,10.564011
11/03/2020 11:02,202001,WESTERN EUROPE-OTHER,SWITZERLAND,BELFAST INTERNATIONAL,GENEVA,5788,5788,0,5019,5019,0,15.321777
11/03/2020 11:02,202001,WESTERN EUROPE-OTHER,SWITZERLAND,BIGGIN HILL,GENEVA,0,0,0,5,0,5,-100
11/03/2020 11:02,202001,WESTERN EUROPE-OTHER,SWITZERLAND,BIGGIN HILL,ZURICH,0,0,0,149,0,149,-100
11/03/2020 11:02,202001,WESTERN EUROPE-OTHER,SWITZERLAND,BIRMINGHAM,GENEVA,23168,23168,0,21078,19983,1095,9.915552
11/03/2020 11:02,202001,WESTERN EUROPE-OTHER,SWITZERLAND,BIRMINGHAM,ZURICH,8705,8705,0,8127,8127,0,7.112095
11/03/2020 11:02,202001,WESTERN EUROPE-OTHER,SWITZERLAND,BOURNEMOUTH,GENEVA,7045,7045,0,6360,6360,0,10.77044
11/03/2020 11:02,202001,WESTERN EUROPE-OTHER,SWITZERLAND,BRISTOL,BALE MULHOUSE,3159,3159,0,2468,2468,0,27.998379
11/03/2020 11:02,202001,WESTERN EUROPE-OTHER,SWITZERLAND,BRISTOL,GENEVA,32380,30846,1534,30380,26959,3421,6.583278
11/03/2020 11:02,202001,WESTERN EUROPE-OTHER,SWITZERLAND,CARDIFF WALES,GENEVA,566,566,0,956,956,0,-40.794979
11/03/2020 11:02,202001,WESTERN EUROPE-OTHER,SWITZERLAND,EAST MIDLANDS INTERNATIONAL,GENEVA,1056,1056,0,1019,1019,0,3.631011
11/03/2020 11:02,202001,WESTERN EUROPE-OTHER,SWITZERLAND,EDINBURGH,BALE MULHOUSE,3638,3638,0,2975,2975,0,22.285714
11/03/2020 11:02,202001,WESTERN EUROPE-OTHER,SWITZERLAND,EDINBURGH,GENEVA,24120,22616,1504,22131,20733,1398,8.987393
11/03/2020 11:02,202001,WESTERN EUROPE-OTHER,SWITZERLAND,EDINBURGH,ZURICH,493,493,0,543,543,0,-9.208103
11/03/2020 11:02,202001,WESTERN EUROPE-OTHER,SWITZERLAND,EXETER,GENEVA,410,410,0,497,497,0,-17.50503
11/03/2020 11:02,202001,WESTERN EUROPE-OTHER,SWITZERLAND,GLASGOW,GENEVA,3487,3487,0,3362,3362,0,3.718025
11/03/2020 11:02,202001,WESTERN EUROPE-OTHER,SWITZERLAND,ISLE OF MAN,GENEVA,480,0,480,467,467,0,2.783726
11/03/2020 11:02,202001,WESTERN EUROPE-OTHER,SWITZERLAND,JERSEY,GENEVA,405,405,0,485,485,0,-16.494845
11/03/2020 11:02,202001,WESTERN EUROPE-OTHER,SWITZERLAND,LEEDS BRADFORD,GENEVA,9063,9063,0,8157,8157,0,11.107025
11/03/2020 11:02,202001,WESTERN EUROPE-OTHER,SWITZERLAND,LIVERPOOL (JOHN LENNON),GENEVA,22169,22169,0,21228,21228,0,4.432825
11/03/2020 11:02,202001,WESTERN EUROPE-OTHER,SWITZERLAND,MANCHESTER,BALE MULHOUSE,5668,5668,0,5665,5665,0,0.052957
11/03/2020 11:02,202001,WESTERN EUROPE-OTHER,SWITZERLAND,MANCHESTER,GENEVA,31367,31367,0,31587,30235,1352,-0.696489
11/03/2020 11:02,202001,WESTERN EUROPE-OTHER,SWITZERLAND,MANCHESTER,ZURICH,12424,12424,0,11311,11311,0,9.839979
11/03/2020 11:02,202001,WESTERN EUROPE-OTHER,SWITZERLAND,NEWCASTLE,GENEVA,9539,9539,0,9202,9202,0,3.662247
11/03/2020 11:02,202001,WESTERN EUROPE-OTHER,SWITZERLAND,SOUTHAMPTON,GENEVA,3495,3495,0,4635,4635,0,-24.595469
11/03/2020 11:02,202001,WESTERN EUROPE-OTHER,TURKEY,GATWICK,ANKARA (ESENBOGA),1651,1651,0,1345,1345,0,22.750929
11/03/2020 11:02,202001,WESTERN EUROPE-OTHER,TURKEY,GATWICK,ANTALYA,650,650,0,2000,2000,0,-67.5
11/03/2020 11:02,202001,WESTERN EUROPE-OTHER,TURKEY,GATWICK,DALAMAN,0,0,0,1228,1228,0,-100
11/03/2020 11:02,202001,WESTERN EUROPE-OTHER,TURKEY,GATWICK,ISTANBUL,17147,17147,0,17981,17810,171,-4.638229
11/03/2020 11:02,202001,WESTERN EUROPE-OTHER,TURKEY,GATWICK,ISTANBUL (SABIHA GOKCEN),5101,5101,0,5249,5249,0,-2.819585
11/03/2020 11:02,202001,WESTERN EUROPE-OTHER,TURKEY,HEATHROW,ISTANBUL,80450,80450,0,79083,79083,0,1.728564
11/03/2020 11:02,202001,WESTERN EUROPE-OTHER,TURKEY,STANSTED,ANKARA (ESENBOGA),481,481,0,0,0,0,0
11/03/2020 11:02,202001,WESTERN EUROPE-OTHER,TURKEY,STANSTED,ANTALYA,2761,2761,0,250,250,0,1004.4
11/03/2020 11:02,202001,WESTERN EUROPE-OTHER,TURKEY,STANSTED,ISTANBUL,1247,1247,0,8313,8313,0,-84.999399
11/03/2020 11:02,202001,WESTERN EUROPE-OTHER,TURKEY,STANSTED,ISTANBUL (SABIHA GOKCEN),46106,46106,0,32616,32616,0,41.360069
11/03/2020 11:02,202001,WESTERN EUROPE-OTHER,TURKEY,STANSTED,IZMIR (ADNAN MENDERES),4901,4901,0,4529,4529,0,8.213734
11/03/2020 11:02,202001,WESTERN EUROPE-OTHER,TURKEY,BIRMINGHAM,ANTALYA,1672,1672,0,219,219,0,663.47032
11/03/2020 11:02,202001,WESTERN EUROPE-OTHER,TURKEY,BIRMINGHAM,ISTANBUL,10973,10973,0,0,0,0,0
11/03/2020 11:02,202001,WESTERN EUROPE-OTHER,TURKEY,BIRMINGHAM,ISTANBUL ATATURK,0,0,0,10005,10005,0,-100
11/03/2020 11:02,202001,WESTERN EUROPE-OTHER,TURKEY,DONCASTER SHEFFIELD,ANTALYA,0,0,0,175,175,0,-100
11/03/2020 11:02,202001,WESTERN EUROPE-OTHER,TURKEY,EDINBURGH,ISTANBUL,7186,7186,0,0,0,0,0
11/03/2020 11:02,202001,WESTERN EUROPE-OTHER,TURKEY,EDINBURGH,ISTANBUL ATATURK,0,0,0,5039,5039,0,-100
11/03/2020 11:02,202001,WESTERN EUROPE-OTHER,TURKEY,GLASGOW,ANTALYA,1416,1416,0,1649,1649,0,-14.129776
11/03/2020 11:02,202001,WESTERN EUROPE-OTHER,TURKEY,LEEDS BRADFORD,ANTALYA,206,206,0,0,0,0,0
11/03/2020 11:02,202001,WESTERN EUROPE-OTHER,TURKEY,MANCHESTER,ANTALYA,3994,3142,852,6477,5632,845,-38.335649
11/03/2020 11:02,202001,WESTERN EUROPE-OTHER,TURKEY,MANCHESTER,DALAMAN,0,0,0,976,976,0,-100
11/03/2020 11:02,202001,WESTERN EUROPE-OTHER,TURKEY,MANCHESTER,ISTANBUL,19510,19510,0,0,0,0,0
11/03/2020 11:02,202001,WESTERN EUROPE-OTHER,TURKEY,MANCHESTER,ISTANBUL (SABIHA GOKCEN),11142,11142,0,0,0,0,0
11/03/2020 11:02,202001,WESTERN EUROPE-OTHER,TURKEY,MANCHESTER,ISTANBUL ATATURK,0,0,0,18988,18988,0,-100
11/03/2020 11:02,202001,WESTERN EUROPE-OTHER,TURKEY,NEWCASTLE,ANTALYA,235,235,0,0,0,0,0
11/03/2020 11:02,202001,EASTERN EUROPE-EU,BULGARIA,GATWICK,SOFIA,17152,14424,2728,16314,13510,2804,5.136692
11/03/2020 11:02,202001,EASTERN EUROPE-EU,BULGARIA,HEATHROW,SOFIA,13030,13030,0,14050,14050,0,-7.259786
11/03/2020 11:02,202001,EASTERN EUROPE-EU,BULGARIA,LUTON,BURGAS,3658,3658,0,4235,4235,0,-13.624557
11/03/2020 11:02,202001,EASTERN EUROPE-EU,BULGARIA,LUTON,SOFIA,27693,27693,0,25113,25113,0,10.273563
11/03/2020 11:02,202001,EASTERN EUROPE-EU,BULGARIA,LUTON,VARNA,10334,10334,0,7888,7888,0,31.009128
11/03/2020 11:02,202001,EASTERN EUROPE-EU,BULGARIA,SOUTHEND,SOFIA,2423,2423,0,2454,2454,0,-1.263244
11/03/2020 11:02,202001,EASTERN EUROPE-EU,BULGARIA,STANSTED,PLOVDIV,6593,6593,0,4885,4885,0,34.964176
11/03/2020 11:02,202001,EASTERN EUROPE-EU,BULGARIA,STANSTED,SOFIA,27134,27134,0,22260,22260,0,21.895777
11/03/2020 11:02,202001,EASTERN EUROPE-EU,BULGARIA,BELFAST INTERNATIONAL,PLOVDIV,1445,0,1445,1729,0,1729,-16.42568
11/03/2020 11:02,202001,EASTERN EUROPE-EU,BULGARIA,BELFAST INTERNATIONAL,SOFIA,2397,0,2397,0,0,0,0
11/03/2020 11:02,202001,EASTERN EUROPE-EU,BULGARIA,BIRMINGHAM,SOFIA,5909,4411,1498,7111,5542,1569,-16.903389
11/03/2020 11:02,202001,EASTERN EUROPE-EU,BULGARIA,BRISTOL,SOFIA,6466,4622,1844,5607,3921,1686,15.320136
11/03/2020 11:02,202001,EASTERN EUROPE-EU,BULGARIA,EAST MIDLANDS INTERNATIONAL,SOFIA,2160,904,1256,1079,0,1079,100.185357
11/03/2020 11:02,202001,EASTERN EUROPE-EU,BULGARIA,EDINBURGH,SOFIA,6349,6349,0,5653,5653,0,12.312047
11/03/2020 11:02,202001,EASTERN EUROPE-EU,BULGARIA,LIVERPOOL (JOHN LENNON),SOFIA,2980,2980,0,3037,3037,0,-1.876852
11/03/2020 11:02,202001,EASTERN EUROPE-EU,BULGARIA,LIVERPOOL (JOHN LENNON),VARNA,2843,2843,0,0,0,0,0
11/03/2020 11:02,202001,EASTERN EUROPE-EU,BULGARIA,MANCHESTER,SOFIA,8871,7326,1545,10207,7463,2744,-13.089057
11/03/2020 11:02,202001,EASTERN EUROPE-EU,BULGARIA,NEWCASTLE,SOFIA,1264,1264,0,1092,1092,0,15.750916
11/03/2020 11:02,202001,EASTERN EUROPE-EU,CZECH REPUBLIC,GATWICK,PRAGUE,15169,15169,0,19823,19823,0,-23.477778
11/03/2020 11:02,202001,EASTERN EUROPE-EU,CZECH REPUBLIC,HEATHROW,PRAGUE,29121,29121,0,27234,27234,0,6.928839
11/03/2020 11:02,202001,EASTERN EUROPE-EU,CZECH REPUBLIC,LONDON CITY,PRAGUE,3245,3245,0,2970,2970,0,9.259259
11/03/2020 11:02,202001,EASTERN EUROPE-EU,CZECH REPUBLIC,LUTON,PRAGUE,14062,14062,0,7609,7609,0,84.807465
11/03/2020 11:02,202001,EASTERN EUROPE-EU,CZECH REPUBLIC,SOUTHEND,PRAGUE,2440,2440,0,3506,3506,0,-30.40502
11/03/2020 11:02,202001,EASTERN EUROPE-EU,CZECH REPUBLIC,STANSTED,BRNO (TURANY),6940,6940,0,6768,6768,0,2.541371
11/03/2020 11:02,202001,EASTERN EUROPE-EU,CZECH REPUBLIC,STANSTED,OSTRAVA,4685,4685,0,5646,5646,0,-17.0209
11/03/2020 11:02,202001,EASTERN EUROPE-EU,CZECH REPUBLIC,STANSTED,PARDUBICE,0,0,0,3561,3561,0,-100
11/03/2020 11:02,202001,EASTERN EUROPE-EU,CZECH REPUBLIC,STANSTED,PRAGUE,31913,31913,0,32839,32839,0,-2.819818
11/03/2020 11:02,202001,EASTERN EUROPE-EU,CZECH REPUBLIC,BELFAST INTERNATIONAL,PRAGUE,2490,2490,0,2261,2261,0,10.128262
11/03/2020 11:02,202001,EASTERN EUROPE-EU,CZECH REPUBLIC,BIRMINGHAM,PRAGUE,3335,3335,0,4687,4687,0,-28.845744
11/03/2020 11:02,202001,EASTERN EUROPE-EU,CZECH REPUBLIC,BOURNEMOUTH,PRAGUE,2876,2876,0,0,0,0,0
11/03/2020 11:02,202001,EASTERN EUROPE-EU,CZECH REPUBLIC,BRISTOL,PRAGUE,6367,6367,0,7173,7173,0,-11.236582
11/03/2020 11:02,202001,EASTERN EUROPE-EU,CZECH REPUBLIC,EAST MIDLANDS INTERNATIONAL,PRAGUE,2316,2316,0,400,400,0,479
11/03/2020 11:02,202001,EASTERN EUROPE-EU,CZECH REPUBLIC,EDINBURGH,PRAGUE,10105,10105,0,9976,9976,0,1.293103
11/03/2020 11:02,202001,EASTERN EUROPE-EU,CZECH REPUBLIC,GLASGOW,PRAGUE,2661,2661,0,2615,2615,0,1.759082
11/03/2020 11:02,202001,EASTERN EUROPE-EU,CZECH REPUBLIC,LEEDS BRADFORD,PRAGUE,499,499,0,459,459,0,8.714597
11/03/2020 11:02,202001,EASTERN EUROPE-EU,CZECH REPUBLIC,LIVERPOOL (JOHN LENNON),PRAGUE,2771,2771,0,7072,7072,0,-60.817308
11/03/2020 11:02,202001,EASTERN EUROPE-EU,CZECH REPUBLIC,MANCHESTER,PRAGUE,28368,28368,0,18117,18117,0,56.582216
11/03/2020 11:02,202001,EASTERN EUROPE-EU,CZECH REPUBLIC,NEWCASTLE,PRAGUE,2812,2812,0,444,444,0,533.333333
11/03/2020 11:02,202001,EASTERN EUROPE-EU,ESTONIA,GATWICK,TALLIN,5387,5387,0,4374,4374,0,23.159579
11/03/2020 11:02,202001,EASTERN EUROPE-EU,ESTONIA,HEATHROW,TALLIN,0,0,0,2309,2309,0,-100
11/03/2020 11:02,202001,EASTERN EUROPE-EU,ESTONIA,LUTON,TALLIN,0,0,0,2922,2922,0,-100
11/03/2020 11:02,202001,EASTERN EUROPE-EU,ESTONIA,STANSTED,TALLIN,6772,6772,0,6153,6153,0,10.060133
11/03/2020 11:02,202001,EASTERN EUROPE-EU,ESTONIA,EDINBURGH,TALLIN,2860,2860,0,2508,2508,0,14.035088
11/03/2020 11:02,202001,EASTERN EUROPE-EU,HUNGARY,GATWICK,BUDAPEST,26939,26939,0,13969,13873,96,92.84845
11/03/2020 11:02,202001,EASTERN EUROPE-EU,HUNGARY,HEATHROW,BUDAPEST,20779,20779,0,21349,21349,0,-2.669914
11/03/2020 11:02,202001,EASTERN EUROPE-EU,HUNGARY,LONDON CITY,BUDAPEST,3726,3726,0,0,0,0,0
11/03/2020 11:02,202001,EASTERN EUROPE-EU,HUNGARY,LUTON,BUDAPEST,40713,40713,0,43410,43410,0,-6.212854
11/03/2020 11:02,202001,EASTERN EUROPE-EU,HUNGARY,LUTON,DEBRECEN,11358,11358,0,11150,11150,0,1.865471
11/03/2020 11:02,202001,EASTERN EUROPE-EU,HUNGARY,SOUTHEND,BUDAPEST,2071,2071,0,2199,2199,0,-5.820828
11/03/2020 11:02,202001,EASTERN EUROPE-EU,HUNGARY,STANSTED,BUDAPEST,34634,34634,0,36131,36131,0,-4.143256
11/03/2020 11:02,202001,EASTERN EUROPE-EU,HUNGARY,BIRMINGHAM,BUDAPEST,5563,5563,0,3176,3176,0,75.157431
11/03/2020 11:02,202001,EASTERN EUROPE-EU,HUNGARY,BRISTOL,BUDAPEST,6274,6274,0,5213,5213,0,20.352964
11/03/2020 11:02,202001,EASTERN EUROPE-EU,HUNGARY,DONCASTER SHEFFIELD,BUDAPEST,3374,3374,0,2765,2765,0,22.025316
11/03/2020 11:02,202001,EASTERN EUROPE-EU,HUNGARY,DONCASTER SHEFFIELD,DEBRECEN,2822,2822,0,2352,2352,0,19.982993
11/03/2020 11:02,202001,EASTERN EUROPE-EU,HUNGARY,EAST MIDLANDS INTERNATIONAL,BUDAPEST,4025,4025,0,3796,3796,0,6.032666
11/03/2020 11:02,202001,EASTERN EUROPE-EU,HUNGARY,EDINBURGH,BUDAPEST,17036,17036,0,5841,5841,0,191.662387
11/03/2020 11:02,202001,EASTERN EUROPE-EU,HUNGARY,GLASGOW,BUDAPEST,2906,2906,0,2834,2834,0,2.540579
11/03/2020 11:02,202001,EASTERN EUROPE-EU,HUNGARY,LEEDS BRADFORD,BUDAPEST,258,258,0,481,481,0,-46.361746
11/03/2020 11:02,202001,EASTERN EUROPE-EU,HUNGARY,LIVERPOOL (JOHN LENNON),BUDAPEST,2878,2878,0,3951,3922,29,-27.157682
11/03/2020 11:02,202001,EASTERN EUROPE-EU,HUNGARY,MANCHESTER,BUDAPEST,16272,16272,0,14152,14152,0,14.980215
11/03/2020 11:02,202001,EASTERN EUROPE-EU,LATVIA,GATWICK,RIGA,8713,8713,0,8134,8134,0,7.118269
11/03/2020 11:02,202001,EASTERN EUROPE-EU,LATVIA,LUTON,RIGA,13675,13675,0,14569,14569,0,-6.136317
11/03/2020 11:02,202001,EASTERN EUROPE-EU,LATVIA,STANSTED,RIGA,22340,22340,0,21197,21197,0,5.392272
11/03/2020 11:02,202001,EASTERN EUROPE-EU,LATVIA,DONCASTER SHEFFIELD,RIGA,3111,3111,0,3419,3419,0,-9.008482
11/03/2020 11:02,202001,EASTERN EUROPE-EU,LATVIA,EAST MIDLANDS INTERNATIONAL,RIGA,5830,5830,0,4900,4900,0,18.979592
11/03/2020 11:02,202001,EASTERN EUROPE-EU,LATVIA,EDINBURGH,RIGA,4297,4297,0,1801,1801,0,138.589672
11/03/2020 11:02,202001,EASTERN EUROPE-EU,LATVIA,LEEDS BRADFORD,RIGA,3395,3395,0,3215,3215,0,5.598756
11/03/2020 11:02,202001,EASTERN EUROPE-EU,LATVIA,MANCHESTER,RIGA,4403,4403,0,3139,3139,0,40.267601
11/03/2020 11:02,202001,EASTERN EUROPE-EU,LITHUANIA,LONDON CITY,VILNIUS,4682,4682,0,0,0,0,0
11/03/2020 11:02,202001,EASTERN EUROPE-EU,LITHUANIA,LUTON,KAUNAS,20028,20028,0,19607,19607,0,2.147192
11/03/2020 11:02,202001,EASTERN EUROPE-EU,LITHUANIA,LUTON,PALANGA,4036,4036,0,5286,5286,0,-23.64737
11/03/2020 11:02,202001,EASTERN EUROPE-EU,LITHUANIA,LUTON,VILNIUS,18532,18532,0,25413,25413,0,-27.076693
11/03/2020 11:02,202001,EASTERN EUROPE-EU,LITHUANIA,SOUTHEND,VILNIUS,7890,7890,0,0,0,0,0
11/03/2020 11:02,202001,EASTERN EUROPE-EU,LITHUANIA,STANSTED,KAUNAS,7497,7497,0,7792,7792,0,-3.785934
11/03/2020 11:02,202001,EASTERN EUROPE-EU,LITHUANIA,STANSTED,PALANGA,2776,2776,0,3759,3759,0,-26.150572
11/03/2020 11:02,202001,EASTERN EUROPE-EU,LITHUANIA,STANSTED,VILNIUS,10807,10807,0,10835,10835,0,-0.258422
11/03/2020 11:02,202001,EASTERN EUROPE-EU,LITHUANIA,BELFAST INTERNATIONAL,VILNIUS,2851,2851,0,3505,3505,0,-18.659058
11/03/2020 11:02,202001,EASTERN EUROPE-EU,LITHUANIA,BIRMINGHAM,VILNIUS,30,30,0,3068,3068,0,-99.022164
11/03/2020 11:02,202001,EASTERN EUROPE-EU,LITHUANIA,BRISTOL,KAUNAS,3435,3435,0,3043,3043,0,12.882024
11/03/2020 11:02,202001,EASTERN EUROPE-EU,LITHUANIA,DONCASTER SHEFFIELD,VILNIUS,4435,4435,0,3488,3488,0,27.150229
11/03/2020 11:02,202001,EASTERN EUROPE-EU,LITHUANIA,EDINBURGH,KAUNAS,2682,2682,0,0,0,0,0
11/03/2020 11:02,202001,EASTERN EUROPE-EU,LITHUANIA,LEEDS BRADFORD,VILNIUS,0,0,0,2938,2938,0,-100
11/03/2020 11:02,202001,EASTERN EUROPE-EU,LITHUANIA,LIVERPOOL (JOHN LENNON),VILNIUS,3138,3138,0,3658,3658,0,-14.215418
11/03/2020 11:02,202001,EASTERN EUROPE-EU,POLAND,GATWICK,GDANSK,10708,10708,0,0,0,0,0
11/03/2020 11:02,202001,EASTERN EUROPE-EU,POLAND,GATWICK,KRAKOW,14562,14205,357,12550,12462,88,16.031873
11/03/2020 11:02,202001,EASTERN EUROPE-EU,POLAND,GATWICK,WARSAW (CHOPIN),0,0,0,4869,4869,0,-100
11/03/2020 11:02,202001,EASTERN EUROPE-EU,POLAND,HEATHROW,KRAKOW,5697,5697,0,6409,6409,0,-11.109377
11/03/2020 11:02,202001,EASTERN EUROPE-EU,POLAND,HEATHROW,WARSAW (CHOPIN),37234,37234,0,33608,33608,0,10.789098
11/03/2020 11:02,202001,EASTERN EUROPE-EU,POLAND,LONDON CITY,WARSAW (CHOPIN),6240,6240,0,3803,3803,0,64.080989
11/03/2020 11:02,202001,EASTERN EUROPE-EU,POLAND,LUTON,BYDGOSZCZ,4357,4357,0,4314,4314,0,0.996755
11/03/2020 11:02,202001,EASTERN EUROPE-EU,POLAND,LUTON,GDANSK,18045,18045,0,24087,24087,0,-25.08407
11/03/2020 11:02,202001,EASTERN EUROPE-EU,POLAND,LUTON,KATOWICE,21979,21979,0,27625,27625,0,-20.438009
11/03/2020 11:02,202001,EASTERN EUROPE-EU,POLAND,LUTON,KRAKOW,29040,29040,0,4476,4476,0,548.793566
11/03/2020 11:02,202001,EASTERN EUROPE-EU,POLAND,LUTON,LUBLIN (PORT LOTNICZY),12140,12140,0,9434,9434,0,28.683485
11/03/2020 11:02,202001,EASTERN EUROPE-EU,POLAND,LUTON,POZNAN,10179,10179,0,11252,11252,0,-9.536082
11/03/2020 11:02,202001,EASTERN EUROPE-EU,POLAND,LUTON,RZESZOW,4397,4397,0,4732,4732,0,-7.079459
11/03/2020 11:02,202001,EASTERN EUROPE-EU,POLAND,LUTON,SZYMANY (MAZURY),3758,3758,0,2855,2855,0,31.628722
11/03/2020 11:02,202001,EASTERN EUROPE-EU,POLAND,LUTON,WARSAW (CHOPIN),38085,38085,0,36929,36929,0,3.130331
11/03/2020 11:02,202001,EASTERN EUROPE-EU,POLAND,LUTON,WROCLAW,11011,11011,0,11901,11901,0,-7.478363
11/03/2020 11:02,202001,EASTERN EUROPE-EU,POLAND,STANSTED,BYDGOSZCZ,8966,8966,0,8714,8714,0,2.891898
11/03/2020 11:02,202001,EASTERN EUROPE-EU,POLAND,STANSTED,GDANSK,16033,16033,0,16747,16747,0,-4.26345
11/03/2020 11:02,202001,EASTERN EUROPE-EU,POLAND,STANSTED,KATOWICE,14190,14190,0,10485,10485,0,35.336195
11/03/2020 11:02,202001,EASTERN EUROPE-EU,POLAND,STANSTED,KRAKOW,27724,27724,0,27565,27565,0,0.576818
11/03/2020 11:02,202001,EASTERN EUROPE-EU,POLAND,STANSTED,LODZ LUBLINEK,8837,8837,0,8548,8548,0,3.380908
11/03/2020 11:02,202001,EASTERN EUROPE-EU,POLAND,STANSTED,LUBLIN (PORT LOTNICZY),0,0,0,6145,6145,0,-100
11/03/2020 11:02,202001,EASTERN EUROPE-EU,POLAND,STANSTED,POZNAN,13163,13163,0,12435,12435,0,5.854443
11/03/2020 11:02,202001,EASTERN EUROPE-EU,POLAND,STANSTED,RZESZOW,8052,8052,0,7979,7979,0,0.914902
11/03/2020 11:02,202001,EASTERN EUROPE-EU,POLAND,STANSTED,SZCZECIN (GOLENOW),7369,7369,0,7360,7360,0,0.122283
11/03/2020 11:02,202001,EASTERN EUROPE-EU,POLAND,STANSTED,SZYMANY (MAZURY),3151,3151,0,4389,4389,0,-28.206881
11/03/2020 11:02,202001,EASTERN EUROPE-EU,POLAND,STANSTED,WARSAW (MODLIN MASOVIA),30355,30355,0,30090,30090,0,0.880691
11/03/2020 11:02,202001,EASTERN EUROPE-EU,POLAND,STANSTED,WROCLAW,18052,18052,0,16299,16299,0,10.755261
11/03/2020 11:02,202001,EASTERN EUROPE-EU,POLAND,ABERDEEN,GDANSK,2906,2906,0,2744,2744,0,5.90379
11/03/2020 11:02,202001,EASTERN EUROPE-EU,POLAND,BELFAST INTERNATIONAL,GDANSK,0,0,0,3054,3054,0,-100
11/03/2020 11:02,202001,EASTERN EUROPE-EU,POLAND,BELFAST INTERNATIONAL,KRAKOW,6367,6367,0,9062,9062,0,-29.739572
11/03/2020 11:02,202001,EASTERN EUROPE-EU,POLAND,BELFAST INTERNATIONAL,WARSAW (MODLIN MASOVIA),0,0,0,2890,2890,0,-100
11/03/2020 11:02,202001,EASTERN EUROPE-EU,POLAND,BELFAST INTERNATIONAL,WROCLAW,0,0,0,2623,2623,0,-100
11/03/2020 11:02,202001,EASTERN EUROPE-EU,POLAND,BIRMINGHAM,BYDGOSZCZ,4740,4740,0,5127,5127,0,-7.548274
11/03/2020 11:02,202001,EASTERN EUROPE-EU,POLAND,BIRMINGHAM,GDANSK,3634,3634,0,3775,3775,0,-3.735099
11/03/2020 11:02,202001,EASTERN EUROPE-EU,POLAND,BIRMINGHAM,KATOWICE,3331,3331,0,2773,2773,0,20.122611
11/03/2020 11:02,202001,EASTERN EUROPE-EU,POLAND,BIRMINGHAM,KRAKOW,12320,12320,0,6030,6030,0,104.311774
11/03/2020 11:02,202001,EASTERN EUROPE-EU,POLAND,BIRMINGHAM,POZNAN,2359,2359,0,604,604,0,290.562914
11/03/2020 11:02,202001,EASTERN EUROPE-EU,POLAND,BIRMINGHAM,WARSAW (CHOPIN),3383,3383,0,4175,4175,0,-18.97006
11/03/2020 11:02,202001,EASTERN EUROPE-EU,POLAND,BIRMINGHAM,WARSAW (MODLIN MASOVIA),4871,4871,0,4133,4133,0,17.856279
11/03/2020 11:02,202001,EASTERN EUROPE-EU,POLAND,BIRMINGHAM,WROCLAW,2148,2148,0,2573,2573,0,-16.517684
11/03/2020 11:02,202001,EASTERN EUROPE-EU,POLAND,BOURNEMOUTH,KRAKOW,3473,3473,0,2781,2781,0,24.883136
11/03/2020 11:02,202001,EASTERN EUROPE-EU,POLAND,BRISTOL,GDANSK,3762,3762,0,3055,3055,0,23.14239
11/03/2020 11:02,202001,EASTERN EUROPE-EU,POLAND,BRISTOL,KATOWICE,3529,3529,0,3191,3191,0,10.592291
11/03/2020 11:02,202001,EASTERN EUROPE-EU,POLAND,BRISTOL,KRAKOW,10630,10630,0,11648,11648,0,-8.739698
11/03/2020 11:02,202001,EASTERN EUROPE-EU,POLAND,BRISTOL,POZNAN,4634,4634,0,4548,4548,0,1.890941
11/03/2020 11:02,202001,EASTERN EUROPE-EU,POLAND,BRISTOL,RZESZOW,3044,3044,0,2904,2904,0,4.820937
11/03/2020 11:02,202001,EASTERN EUROPE-EU,POLAND,BRISTOL,WARSAW (MODLIN MASOVIA),6104,6104,0,6260,6260,0,-2.492013
11/03/2020 11:02,202001,EASTERN EUROPE-EU,POLAND,BRISTOL,WROCLAW,3408,3408,0,3243,3243,0,5.087882
11/03/2020 11:02,202001,EASTERN EUROPE-EU,POLAND,DONCASTER SHEFFIELD,GDANSK,6123,6123,0,6095,6095,0,0.459393
11/03/2020 11:02,202001,EASTERN EUROPE-EU,POLAND,DONCASTER SHEFFIELD,KATOWICE,5874,5874,0,6065,6065,0,-3.149217
11/03/2020 11:02,202001,EASTERN EUROPE-EU,POLAND,DONCASTER SHEFFIELD,KRAKOW,3247,3247,0,0,0,0,0
11/03/2020 11:02,202001,EASTERN EUROPE-EU,POLAND,DONCASTER SHEFFIELD,POZNAN,4340,4340,0,4731,4731,0,-8.264637
11/03/2020 11:02,202001,EASTERN EUROPE-EU,POLAND,DONCASTER SHEFFIELD,WARSAW (CHOPIN),4768,4768,0,4319,4319,0,10.395925
11/03/2020 11:02,202001,EASTERN EUROPE-EU,POLAND,DONCASTER SHEFFIELD,WROCLAW,2895,2895,0,2630,2630,0,10.076046
11/03/2020 11:02,202001,EASTERN EUROPE-EU,POLAND,EAST MIDLANDS INTERNATIONAL,KRAKOW,5028,5028,0,5435,5435,0,-7.4885
11/03/2020 11:02,202001,EASTERN EUROPE-EU,POLAND,EAST MIDLANDS INTERNATIONAL,LODZ LUBLINEK,3936,3936,0,2810,2810,0,40.071174
11/03/2020 11:02,202001,EASTERN EUROPE-EU,POLAND,EAST MIDLANDS INTERNATIONAL,RZESZOW,4748,4748,0,5434,5434,0,-12.624218
11/03/2020 11:02,202001,EASTERN EUROPE-EU,POLAND,EAST MIDLANDS INTERNATIONAL,WARSAW (MODLIN MASOVIA),3675,3675,0,5096,5096,0,-27.884615
11/03/2020 11:02,202001,EASTERN EUROPE-EU,POLAND,EAST MIDLANDS INTERNATIONAL,WROCLAW,6796,6796,0,6413,6413,0,5.972244
11/03/2020 11:02,202001,EASTERN EUROPE-EU,POLAND,EDINBURGH,GDANSK,11238,11238,0,5421,5421,0,107.304925
11/03/2020 11:02,202001,EASTERN EUROPE-EU,POLAND,EDINBURGH,KATOWICE,3425,3425,0,2788,2788,0,22.84792
11/03/2020 11:02,202001,EASTERN EUROPE-EU,POLAND,EDINBURGH,KRAKOW,11208,11208,0,10810,10810,0,3.681776
11/03/2020 11:02,202001,EASTERN EUROPE-EU,POLAND,EDINBURGH,POZNAN,3958,3958,0,2798,2798,0,41.458184
11/03/2020 11:02,202001,EASTERN EUROPE-EU,POLAND,EDINBURGH,WARSAW (CHOPIN),6555,6555,0,0,0,0,0
11/03/2020 11:02,202001,EASTERN EUROPE-EU,POLAND,EDINBURGH,WARSAW (MODLIN MASOVIA),9688,9688,0,6572,6572,0,47.413268
11/03/2020 11:02,202001,EASTERN EUROPE-EU,POLAND,EDINBURGH,WROCLAW,3023,3023,0,3552,3552,0,-14.893018
11/03/2020 11:02,202001,EASTERN EUROPE-EU,POLAND,GLASGOW,KRAKOW,5909,5909,0,3170,3170,0,86.403785
11/03/2020 11:02,202001,EASTERN EUROPE-EU,POLAND,GLASGOW,WARSAW (MODLIN MASOVIA),2807,2807,0,0,0,0,0
11/03/2020 11:02,202001,EASTERN EUROPE-EU,POLAND,GLASGOW,WROCLAW,3174,3174,0,2580,2580,0,23.023256
11/03/2020 11:02,202001,EASTERN EUROPE-EU,POLAND,LEEDS BRADFORD,GDANSK,4336,4336,0,4280,4280,0,1.308411
11/03/2020 11:02,202001,EASTERN EUROPE-EU,POLAND,LEEDS BRADFORD,KATOWICE,501,501,0,0,0,0,0
11/03/2020 11:02,202001,EASTERN EUROPE-EU,POLAND,LEEDS BRADFORD,KRAKOW,8988,8988,0,7047,7047,0,27.543636
11/03/2020 11:02,202001,EASTERN EUROPE-EU,POLAND,LEEDS BRADFORD,WARSAW (CHOPIN),77,77,0,0,0,0,0
11/03/2020 11:02,202001,EASTERN EUROPE-EU,POLAND,LEEDS BRADFORD,WARSAW (MODLIN MASOVIA),3190,3190,0,3250,3250,0,-1.846154
11/03/2020 11:02,202001,EASTERN EUROPE-EU,POLAND,LEEDS BRADFORD,WROCLAW,3131,3131,0,2525,2525,0,24
11/03/2020 11:02,202001,EASTERN EUROPE-EU,POLAND,LIVERPOOL (JOHN LENNON),GDANSK,4548,4548,0,4360,4360,0,4.311927
11/03/2020 11:02,202001,EASTERN EUROPE-EU,POLAND,LIVERPOOL (JOHN LENNON),KATOWICE,2423,2423,0,3126,3126,0,-22.488804
11/03/2020 11:02,202001,EASTERN EUROPE-EU,POLAND,LIVERPOOL (JOHN LENNON),KRAKOW,9711,9711,0,9076,9076,0,6.996474
11/03/2020 11:02,202001,EASTERN EUROPE-EU,POLAND,LIVERPOOL (JOHN LENNON),POZNAN,2987,2987,0,2880,2880,0,3.715278
11/03/2020 11:02,202001,EASTERN EUROPE-EU,POLAND,LIVERPOOL (JOHN LENNON),SZCZECIN (GOLENOW),3052,3052,0,3022,3022,0,0.99272
11/03/2020 11:02,202001,EASTERN EUROPE-EU,POLAND,LIVERPOOL (JOHN LENNON),WARSAW (CHOPIN),3655,3655,0,2558,2558,0,42.885066
11/03/2020 11:02,202001,EASTERN EUROPE-EU,POLAND,LIVERPOOL (JOHN LENNON),WARSAW (MODLIN MASOVIA),4590,4590,0,5622,5622,0,-18.356457
11/03/2020 11:02,202001,EASTERN EUROPE-EU,POLAND,LIVERPOOL (JOHN LENNON),WROCLAW,2958,2958,0,3473,3473,0,-14.828678
11/03/2020 11:02,202001,EASTERN EUROPE-EU,POLAND,MANCHESTER,GDANSK,3217,3217,0,3726,3726,0,-13.660762
11/03/2020 11:02,202001,EASTERN EUROPE-EU,POLAND,MANCHESTER,KATOWICE,4669,4669,0,0,0,0,0
11/03/2020 11:02,202001,EASTERN EUROPE-EU,POLAND,MANCHESTER,KRAKOW,19086,19086,0,16591,16591,0,15.038274
11/03/2020 11:02,202001,EASTERN EUROPE-EU,POLAND,MANCHESTER,RZESZOW,3808,3808,0,3402,3402,0,11.934156
11/03/2020 11:02,202001,EASTERN EUROPE-EU,POLAND,MANCHESTER,WARSAW (MODLIN MASOVIA),2946,2946,0,4923,4923,0,-40.15844
11/03/2020 11:02,202001,EASTERN EUROPE-EU,POLAND,MANCHESTER,WROCLAW,3646,3646,0,2725,2725,0,33.798165
11/03/2020 11:02,202001,EASTERN EUROPE-EU,POLAND,NEWCASTLE,KRAKOW,3110,3110,0,2668,2668,0,16.566717
11/03/2020 11:02,202001,EASTERN EUROPE-EU,POLAND,NEWCASTLE,WARSAW (MODLIN MASOVIA),0,0,0,2506,2506,0,-100
11/03/2020 11:02,202001,EASTERN EUROPE-EU,POLAND,NEWCASTLE,WROCLAW,3195,3195,0,2765,2765,0,15.551537
11/03/2020 11:02,202001,EASTERN EUROPE-EU,POLAND,PRESTWICK,RZESZOW,0,0,0,2842,2842,0,-100
11/03/2020 11:02,202001,EASTERN EUROPE-EU,ROMANIA,GATWICK,BUCHAREST (OTOPENI),10288,10288,0,11746,11746,0,-12.412736
11/03/2020 11:02,202001,EASTERN EUROPE-EU,ROMANIA,GATWICK,CLUJ NAPOCA,7807,7807,0,0,0,0,0
11/03/2020 11:02,202001,EASTERN EUROPE-EU,ROMANIA,HEATHROW,BUCHAREST (OTOPENI),22242,22242,0,18667,18667,0,19.151444
11/03/2020 11:02,202001,EASTERN EUROPE-EU,ROMANIA,LUTON,BACAU,7306,7306,0,6655,6655,0,9.782119
11/03/2020 11:02,202001,EASTERN EUROPE-EU,ROMANIA,LUTON,BUCHAREST (OTOPENI),47879,47879,0,50673,50673,0,-5.513784
11/03/2020 11:02,202001,EASTERN EUROPE-EU,ROMANIA,LUTON,CLUJ NAPOCA,17601,17601,0,23372,23372,0,-24.691939
11/03/2020 11:02,202001,EASTERN EUROPE-EU,ROMANIA,LUTON,CONSTANTA,4284,4284,0,4376,4376,0,-2.102377
11/03/2020 11:02,202001,EASTERN EUROPE-EU,ROMANIA,LUTON,CRAIOVA,11796,11796,0,8941,8941,0,31.931551
11/03/2020 11:02,202001,EASTERN EUROPE-EU,ROMANIA,LUTON,IASI,15239,15239,0,15822,15822,0,-3.684743
11/03/2020 11:02,202001,EASTERN EUROPE-EU,ROMANIA,LUTON,SATU MARE,3082,3082,0,3559,3559,0,-13.402641
11/03/2020 11:02,202001,EASTERN EUROPE-EU,ROMANIA,LUTON,SIBIU,0,0,0,8588,8588,0,-100
11/03/2020 11:02,202001,EASTERN EUROPE-EU,ROMANIA,LUTON,SUCEAVA,12385,12385,0,10950,10950,0,13.105023
11/03/2020 11:02,202001,EASTERN EUROPE-EU,ROMANIA,LUTON,TIMISOARA,12258,12258,0,10335,10335,0,18.606676
11/03/2020 11:02,202001,EASTERN EUROPE-EU,ROMANIA,LUTON,TIRGU MURES,3100,3100,0,4231,4231,0,-26.731269
11/03/2020 11:02,202001,EASTERN EUROPE-EU,ROMANIA,SOUTHEND,BUCHAREST (OTOPENI),13257,13257,0,0,0,0,0
11/03/2020 11:02,202001,EASTERN EUROPE-EU,ROMANIA,SOUTHEND,SIBIU,8028,8028,0,0,0,0,0
11/03/2020 11:02,202001,EASTERN EUROPE-EU,ROMANIA,STANSTED,BUCHAREST (OTOPENI),25475,25475,0,22457,22457,0,13.439017
11/03/2020 11:02,202001,EASTERN EUROPE-EU,ROMANIA,BIGGIN HILL,BUCHAREST (BANEASA),1,0,1,0,0,0,0
11/03/2020 11:02,202001,EASTERN EUROPE-EU,ROMANIA,BIRMINGHAM,BUCHAREST (OTOPENI),9779,9779,0,9658,9658,0,1.252847
11/03/2020 11:02,202001,EASTERN EUROPE-EU,ROMANIA,BIRMINGHAM,CLUJ NAPOCA,2903,2903,0,2590,2590,0,12.084942
11/03/2020 11:02,202001,EASTERN EUROPE-EU,ROMANIA,BRISTOL,BUCHAREST (OTOPENI),3619,3619,0,3435,3435,0,5.356623
11/03/2020 11:02,202001,EASTERN EUROPE-EU,ROMANIA,DONCASTER SHEFFIELD,BUCHAREST (OTOPENI),6876,6876,0,4692,4692,0,46.547315
11/03/2020 11:02,202001,EASTERN EUROPE-EU,ROMANIA,DONCASTER SHEFFIELD,CLUJ NAPOCA,2757,2757,0,3640,3640,0,-24.258242
11/03/2020 11:02,202001,EASTERN EUROPE-EU,ROMANIA,DONCASTER SHEFFIELD,TIMISOARA,990,990,0,0,0,0,0
11/03/2020 11:02,202001,EASTERN EUROPE-EU,ROMANIA,EDINBURGH,BUCHAREST (OTOPENI),7213,7213,0,0,0,0,0
11/03/2020 11:02,202001,EASTERN EUROPE-EU,ROMANIA,EXETER,CONSTANTA,147,0,147,0,0,0,0
11/03/2020 11:02,202001,EASTERN EUROPE-EU,ROMANIA,GLASGOW,BUCHAREST (OTOPENI),2529,2529,0,3210,3210,0,-21.214953
11/03/2020 11:02,202001,EASTERN EUROPE-EU,ROMANIA,LIVERPOOL (JOHN LENNON),BACAU,2532,2532,0,2305,2305,0,9.848156
11/03/2020 11:02,202001,EASTERN EUROPE-EU,ROMANIA,LIVERPOOL (JOHN LENNON),BUCHAREST (OTOPENI),9315,9315,0,9209,9209,0,1.151048
11/03/2020 11:02,202001,EASTERN EUROPE-EU,ROMANIA,LIVERPOOL (JOHN LENNON),CLUJ NAPOCA,2367,2367,0,2334,2334,0,1.413882
11/03/2020 11:02,202001,EASTERN EUROPE-EU,ROMANIA,LIVERPOOL (JOHN LENNON),IASI,3003,3003,0,2477,2477,0,21.235365
11/03/2020 11:02,202001,EASTERN EUROPE-EU,SLOVAK REPUBLIC,LUTON,BRATISLAVA,6478,6478,0,6380,6380,0,1.53605
11/03/2020 11:02,202001,EASTERN EUROPE-EU,SLOVAK REPUBLIC,LUTON,KOSICE,10984,10984,0,11183,11183,0,-1.779487
11/03/2020 11:02,202001,EASTERN EUROPE-EU,SLOVAK REPUBLIC,LUTON,TATRY-POPRAD,3825,3825,0,5629,5629,0,-32.048321
11/03/2020 11:02,202001,EASTERN EUROPE-EU,SLOVAK REPUBLIC,STANSTED,BRATISLAVA,16108,16108,0,16367,16367,0,-1.582452
11/03/2020 11:02,202001,EASTERN EUROPE-EU,SLOVAK REPUBLIC,BIGGIN HILL,BRATISLAVA,0,0,0,13,0,13,-100
11/03/2020 11:02,202001,EASTERN EUROPE-EU,SLOVAK REPUBLIC,BIRMINGHAM,BRATISLAVA,5389,4857,532,4935,4935,0,9.199595
11/03/2020 11:02,202001,EASTERN EUROPE-EU,SLOVAK REPUBLIC,EDINBURGH,BRATISLAVA,3076,3076,0,2965,2965,0,3.743676
11/03/2020 11:02,202001,EASTERN EUROPE-EU,SLOVAK REPUBLIC,LEEDS BRADFORD,BRATISLAVA,3102,3102,0,2346,2346,0,32.225064
11/03/2020 11:02,202001,EASTERN EUROPE-EU,SLOVAK REPUBLIC,LIVERPOOL (JOHN LENNON),BRATISLAVA,0,0,0,166,166,0,-100
11/03/2020 11:02,202001,EASTERN EUROPE-EU,SLOVAK REPUBLIC,MANCHESTER,BRATISLAVA,3867,3867,0,4749,4749,0,-18.572331
11/03/2020 11:02,202001,EASTERN EUROPE -OTHER,ALBANIA,GATWICK,TIRANA,9359,9359,0,8937,8837,100,4.721942
11/03/2020 11:02,202001,EASTERN EUROPE -OTHER,ALBANIA,LUTON,TIRANA,11172,11172,0,5857,5857,0,90.746116
11/03/2020 11:02,202001,EASTERN EUROPE -OTHER,ALBANIA,STANSTED,TIRANA,1864,1864,0,127,0,127,1367.716535
11/03/2020 11:02,202001,EASTERN EUROPE -OTHER,AZERBAIJAN,HEATHROW,BAKU (HEYDER ALIYEV INT'L),2807,2807,0,2946,2946,0,-4.718262
11/03/2020 11:02,202001,EASTERN EUROPE -OTHER,AZERBAIJAN,BIGGIN HILL,BAKU (HEYDER ALIYEV INT'L),0,0,0,1,0,1,-100
11/03/2020 11:02,202001,EASTERN EUROPE -OTHER,BELARUS,GATWICK,MINSK INT'L ,2898,2898,0,2331,2331,0,24.324324
11/03/2020 11:02,202001,EASTERN EUROPE -OTHER,GEORGIA,GATWICK,TBILISI,747,747,0,935,935,0,-20.106952
11/03/2020 11:02,202001,EASTERN EUROPE -OTHER,GEORGIA,LUTON,KUTAISI,2370,2370,0,1621,1621,0,46.206046
11/03/2020 11:02,202001,EASTERN EUROPE -OTHER,KAZAKHSTAN,HEATHROW,ASTANA,3094,3094,0,2860,2860,0,8.181818
11/03/2020 11:02,202001,EASTERN EUROPE -OTHER,REPUBLIC OF MOLDOVA,LUTON,CHISINAU (KISHINEV),13592,13592,0,10696,10696,0,27.075542
11/03/2020 11:02,202001,EASTERN EUROPE -OTHER,REPUBLIC OF MOLDOVA,STANSTED,CHISINAU (KISHINEV),6111,6111,0,5280,5280,0,15.738636
11/03/2020 11:02,202001,EASTERN EUROPE -OTHER,RUSSIA,GATWICK,ST PETERSBURG,5016,5016,0,3923,3923,0,27.861331
11/03/2020 11:02,202001,EASTERN EUROPE -OTHER,RUSSIA,HEATHROW,MOSCOW (DOMODEDOVO),10663,10663,0,12062,12062,0,-11.598408
11/03/2020 11:02,202001,EASTERN EUROPE -OTHER,RUSSIA,HEATHROW,MOSCOW (SHEREMETYEVO),36866,36866,0,37017,37017,0,-0.407921
11/03/2020 11:02,202001,EASTERN EUROPE -OTHER,RUSSIA,HEATHROW,ST PETERSBURG,0,0,0,4281,4281,0,-100
11/03/2020 11:02,202001,EASTERN EUROPE -OTHER,RUSSIA,LUTON,MOSCOW (VNUKOVO),11781,11781,0,0,0,0,0
11/03/2020 11:02,202001,EASTERN EUROPE -OTHER,RUSSIA,LUTON,ST PETERSBURG,11158,11158,0,0,0,0,0
11/03/2020 11:02,202001,EASTERN EUROPE -OTHER,RUSSIA,STANSTED,MOSCOW (DOMODEDOVO),2304,2304,0,0,0,0,0
11/03/2020 11:02,202001,EASTERN EUROPE -OTHER,RUSSIA,STANSTED,ST PETERSBURG,0,0,0,4788,4788,0,-100
11/03/2020 11:02,202001,EASTERN EUROPE -OTHER,RUSSIA,BIGGIN HILL,MOSCOW (VNUKOVO),0,0,0,7,0,7,-100
11/03/2020 11:02,202001,EASTERN EUROPE -OTHER,TURKMENISTAN,HEATHROW,ASHKHABAD,0,0,0,917,917,0,-100
11/03/2020 11:02,202001,EASTERN EUROPE -OTHER,TURKMENISTAN,BIRMINGHAM,ASHKHABAD,426,426,0,6337,6337,0,-93.277576
11/03/2020 11:02,202001,EASTERN EUROPE -OTHER,UKRAINE,GATWICK,KIEV (BORISPOL),13311,13311,0,14319,14319,0,-7.039598
11/03/2020 11:02,202001,EASTERN EUROPE -OTHER,UKRAINE,HEATHROW,KIEV (BORISPOL),0,0,0,4730,4730,0,-100
11/03/2020 11:02,202001,EASTERN EUROPE -OTHER,UKRAINE,LUTON,KHARKOV OSNOVA INTL,0,0,0,2058,2058,0,-100
11/03/2020 11:02,202001,EASTERN EUROPE -OTHER,UKRAINE,LUTON,KIEV (ZHULYANY),5173,5173,0,3613,3613,0,43.177415
11/03/2020 11:02,202001,EASTERN EUROPE -OTHER,UKRAINE,LUTON,LVOV,3307,3307,0,3367,3367,0,-1.782002
11/03/2020 11:02,202001,EASTERN EUROPE -OTHER,UKRAINE,STANSTED,KIEV (BORISPOL),5938,5938,0,5964,5964,0,-0.435949
11/03/2020 11:02,202001,EASTERN EUROPE -OTHER,UKRAINE,STANSTED,LVOV,4747,4747,0,3646,3646,0,30.197477
11/03/2020 11:02,202001,EASTERN EUROPE -OTHER,UKRAINE,MANCHESTER,KIEV (BORISPOL),3310,3310,0,0,0,0,0
11/03/2020 11:02,202001,EASTERN EUROPE -OTHER,UZBEKISTAN,HEATHROW,TASHKENT,2727,2727,0,2354,2354,0,15.84537
11/03/2020 11:02,202001,NEAR EAST,ISRAEL,GATWICK,TEL AVIV,3155,3155,0,3420,3420,0,-7.748538
11/03/2020 11:02,202001,NEAR EAST,ISRAEL,HEATHROW,TEL AVIV,56568,56568,0,43543,43543,0,29.91296
11/03/2020 11:02,202001,NEAR EAST,ISRAEL,LUTON,OVDA,0,0,0,2163,2163,0,-100
11/03/2020 11:02,202001,NEAR EAST,ISRAEL,LUTON,TEL AVIV,30576,30576,0,32581,32581,0,-6.153893
11/03/2020 11:02,202001,NEAR EAST,ISRAEL,STANSTED,TEL AVIV,3087,2779,308,3543,3543,0,-12.870449
11/03/2020 11:02,202001,NEAR EAST,ISRAEL,BIGGIN HILL,TEL AVIV,0,0,0,9,0,9,-100
11/03/2020 11:02,202001,NEAR EAST,ISRAEL,MANCHESTER,TEL AVIV,5606,5606,0,2930,2930,0,91.331058
11/03/2020 11:02,202001,NEAR EAST,JORDAN,GATWICK,AQABA,2215,2215,0,1170,1170,0,89.316239
11/03/2020 11:02,202001,NEAR EAST,JORDAN,HEATHROW,AMMAN,17298,17298,0,16538,16538,0,4.595477
11/03/2020 11:02,202001,NEAR EAST,LEBANON,HEATHROW,BEIRUT,21198,21198,0,21747,21747,0,-2.524486
11/03/2020 11:02,202001,NORTH AFRICA,ALGERIA,GATWICK,ALGIERS,5714,5714,0,5203,5203,0,9.821257
11/03/2020 11:02,202001,NORTH AFRICA,ALGERIA,HEATHROW,ALGIERS,5302,5302,0,5539,5539,0,-4.278751
11/03/2020 11:02,202001,NORTH AFRICA,EGYPT,GATWICK,HURGHADA,9955,9955,0,14667,14667,0,-32.126543
11/03/2020 11:02,202001,NORTH AFRICA,EGYPT,GATWICK,MARSA ALAM,1629,1629,0,3044,3044,0,-46.484888
11/03/2020 11:02,202001,NORTH AFRICA,EGYPT,GATWICK,SHARM EL SHEIKH (OPHIRA),668,0,668,0,0,0,0
11/03/2020 11:02,202001,NORTH AFRICA,EGYPT,HEATHROW,CAIRO,34117,34117,0,32002,32002,0,6.608962
11/03/2020 11:02,202001,NORTH AFRICA,EGYPT,HEATHROW,LUXOR,784,784,0,845,845,0,-7.218935
11/03/2020 11:02,202001,NORTH AFRICA,EGYPT,STANSTED,HURGHADA,2854,2854,0,2734,2734,0,4.389173
11/03/2020 11:02,202001,NORTH AFRICA,EGYPT,BIRMINGHAM,HURGHADA,5078,5078,0,8556,8556,0,-40.649836
11/03/2020 11:02,202001,NORTH AFRICA,EGYPT,BIRMINGHAM,MARSA ALAM,189,189,0,1463,1463,0,-87.08134
11/03/2020 11:02,202001,NORTH AFRICA,EGYPT,BIRMINGHAM,SHARM EL SHEIKH (OPHIRA),709,0,709,0,0,0,0
11/03/2020 11:02,202001,NORTH AFRICA,EGYPT,BRISTOL,HURGHADA,3817,2684,1133,4238,1400,2838,-9.933931
11/03/2020 11:02,202001,NORTH AFRICA,EGYPT,EAST MIDLANDS INTERNATIONAL,HURGHADA,0,0,0,1549,1549,0,-100
11/03/2020 11:02,202001,NORTH AFRICA,EGYPT,GLASGOW,HURGHADA,0,0,0,230,230,0,-100
11/03/2020 11:02,202001,NORTH AFRICA,EGYPT,MANCHESTER,HURGHADA,9247,8124,1123,12563,12563,0,-26.394969
11/03/2020 11:02,202001,NORTH AFRICA,EGYPT,MANCHESTER,MARSA ALAM,1291,1291,0,0,0,0,0
11/03/2020 11:02,202001,NORTH AFRICA,EGYPT,NEWCASTLE,HURGHADA,0,0,0,1536,1536,0,-100
11/03/2020 11:02,202001,NORTH AFRICA,MOROCCO,GATWICK,AGADIR (AL MASSIRA),7607,7607,0,8670,8670,0,-12.260669
11/03/2020 11:02,202001,NORTH AFRICA,MOROCCO,GATWICK,CASABLANCA MOHAMED V,6583,6577,6,5538,5538,0,18.869628
11/03/2020 11:02,202001,NORTH AFRICA,MOROCCO,GATWICK,ERRACHIDIA,0,0,0,2,0,2,-100
11/03/2020 11:02,202001,NORTH AFRICA,MOROCCO,GATWICK,FEZ,1351,1351,0,1129,1129,0,19.663419
11/03/2020 11:02,202001,NORTH AFRICA,MOROCCO,GATWICK,MARRAKESH,29406,29406,0,25240,25240,0,16.505547
11/03/2020 11:02,202001,NORTH AFRICA,MOROCCO,GATWICK,TANGIERS (IBN BATUTA),2391,2391,0,1902,1902,0,25.709779
11/03/2020 11:02,202001,NORTH AFRICA,MOROCCO,HEATHROW,CASABLANCA MOHAMED V,9155,9155,0,7706,7706,0,18.80353
11/03/2020 11:02,202001,NORTH AFRICA,MOROCCO,HEATHROW,MARRAKESH,4247,4247,0,2112,2112,0,101.089015
11/03/2020 11:02,202001,NORTH AFRICA,MOROCCO,HEATHROW,RABAT,1044,1044,0,1058,1058,0,-1.323251
11/03/2020 11:02,202001,NORTH AFRICA,MOROCCO,LUTON,MARRAKESH,2954,2954,0,2965,2965,0,-0.370995
11/03/2020 11:02,202001,NORTH AFRICA,MOROCCO,STANSTED,AGADIR (AL MASSIRA),1898,1898,0,3459,3459,0,-45.12865
11/03/2020 11:02,202001,NORTH AFRICA,MOROCCO,STANSTED,ESSAOUIRA,2579,2579,0,0,0,0,0
11/03/2020 11:02,202001,NORTH AFRICA,MOROCCO,STANSTED,FEZ,3137,3137,0,2919,2919,0,7.468311
11/03/2020 11:02,202001,NORTH AFRICA,MOROCCO,STANSTED,MARRAKESH,11612,11612,0,10272,10272,0,13.045171
11/03/2020 11:02,202001,NORTH AFRICA,MOROCCO,STANSTED,RABAT,4654,4654,0,4520,4520,0,2.964602
11/03/2020 11:02,202001,NORTH AFRICA,MOROCCO,BELFAST INTERNATIONAL,MARRAKESH,2724,2724,0,0,0,0,0
11/03/2020 11:02,202001,NORTH AFRICA,MOROCCO,BIRMINGHAM,AGADIR (AL MASSIRA),184,184,0,846,846,0,-78.250591
11/03/2020 11:02,202001,NORTH AFRICA,MOROCCO,BIRMINGHAM,MARRAKESH,185,185,0,0,0,0,0
11/03/2020 11:02,202001,NORTH AFRICA,MOROCCO,LIVERPOOL (JOHN LENNON),MARRAKESH,2881,2881,0,2548,2548,0,13.069074
11/03/2020 11:02,202001,NORTH AFRICA,MOROCCO,MANCHESTER,AGADIR (AL MASSIRA),6555,6555,0,9961,9961,0,-34.193354
11/03/2020 11:02,202001,NORTH AFRICA,MOROCCO,MANCHESTER,CASABLANCA MOHAMED V,2001,2001,0,1778,1778,0,12.542182
11/03/2020 11:02,202001,NORTH AFRICA,MOROCCO,MANCHESTER,MARRAKESH,9627,9627,0,9326,9326,0,3.227536
11/03/2020 11:02,202001,NORTH AFRICA,TUNISIA,GATWICK,ENFIDHA - HAMMAMET INTL,1801,0,1801,5169,3786,1383,-65.157671
11/03/2020 11:02,202001,NORTH AFRICA,TUNISIA,GATWICK,TUNIS,2433,2433,0,1955,1955,0,24.450128
11/03/2020 11:02,202001,NORTH AFRICA,TUNISIA,HEATHROW,TUNIS,3548,3548,0,3448,3448,0,2.900232
11/03/2020 11:02,202001,NORTH AFRICA,TUNISIA,BIRMINGHAM,ENFIDHA - HAMMAMET INTL,186,0,186,1298,0,1298,-85.670262
11/03/2020 11:02,202001,NORTH AFRICA,TUNISIA,MANCHESTER,ENFIDHA - HAMMAMET INTL,1816,0,1816,4703,3287,1416,-61.386349
11/03/2020 11:02,202001,EAST AFRICA,ETHIOPIA,HEATHROW,ADDIS ABABA,24732,24732,0,22435,22435,0,10.238467
11/03/2020 11:02,202001,EAST AFRICA,ETHIOPIA,MANCHESTER,ADDIS ABABA,3717,3717,0,2966,2966,0,25.320297
11/03/2020 11:02,202001,EAST AFRICA,KENYA,HEATHROW,NAIROBI,25459,25459,0,25455,25455,0,0.015714
11/03/2020 11:02,202001,EAST AFRICA,RWANDA,GATWICK,KIGALI,2762,2762,0,1332,1332,0,107.357357
11/03/2020 11:02,202001,WEST AFRICA,GAMBIA,GATWICK,BANJUL,3984,0,3984,9869,7547,2322,-59.631168
11/03/2020 11:02,202001,WEST AFRICA,GAMBIA,BIRMINGHAM,BANJUL,1442,0,1442,3647,3647,0,-60.460653
11/03/2020 11:02,202001,WEST AFRICA,GAMBIA,MANCHESTER,BANJUL,1344,0,1344,6525,6525,0,-79.402299
11/03/2020 11:02,202001,WEST AFRICA,GHANA,GATWICK,ACCRA,0,0,0,100,0,100,-100
11/03/2020 11:02,202001,WEST AFRICA,GHANA,HEATHROW,ACCRA,19029,19029,0,18469,18469,0,3.032108
11/03/2020 11:02,202001,WEST AFRICA,NIGERIA,GATWICK,LAGOS,56,0,56,0,0,0,0
11/03/2020 11:02,202001,WEST AFRICA,NIGERIA,HEATHROW,ABUJA,12131,12131,0,11873,11873,0,2.172998
11/03/2020 11:02,202001,WEST AFRICA,NIGERIA,HEATHROW,LAGOS,35289,35289,0,34449,34449,0,2.438387
11/03/2020 11:02,202001,WEST AFRICA,SENEGAL,BIRMINGHAM,DAKAR (BLAISE DIAGNE),166,0,166,0,0,0,0
11/03/2020 11:02,202001,WEST AFRICA,SIERRA LEONE,GATWICK,FREETOWN,21,0,21,0,0,0,0
11/03/2020 11:02,202001,SOUTHERN AFRICA,REPUBLIC OF SOUTH AFRICA,GATWICK,CAPE TOWN,8071,8071,0,13090,13090,0,-38.342246
11/03/2020 11:02,202001,SOUTHERN AFRICA,REPUBLIC OF SOUTH AFRICA,HEATHROW,CAPE TOWN,40822,40568,254,40291,40291,0,1.317912
11/03/2020 11:02,202001,SOUTHERN AFRICA,REPUBLIC OF SOUTH AFRICA,HEATHROW,DURBAN,4843,4843,0,4730,4730,0,2.389006
11/03/2020 11:02,202001,SOUTHERN AFRICA,REPUBLIC OF SOUTH AFRICA,HEATHROW,JOHANNESBURG,87265,87265,0,93862,93862,0,-7.028403
11/03/2020 11:02,202001,MIDDLE EAST,BAHRAIN,HEATHROW,BAHRAIN,38347,38347,0,35957,35957,0,6.646828
11/03/2020 11:02,202001,MIDDLE EAST,IRAN,HEATHROW,TEHRAN IMAM KHOMEINI,3810,3810,0,4251,4251,0,-10.37403
11/03/2020 11:02,202001,MIDDLE EAST,IRAQ,GATWICK,BAGHDAD (GECA),0,0,0,1151,1130,21,-100
11/03/2020 11:02,202001,MIDDLE EAST,IRAQ,GATWICK,SULAYMANIYAH INT,0,0,0,396,396,0,-100
11/03/2020 11:02,202001,MIDDLE EAST,IRAQ,MANCHESTER,BAGHDAD (GECA),0,0,0,934,934,0,-100
11/03/2020 11:02,202001,MIDDLE EAST,KUWAIT,GATWICK,KUWAIT,6952,6952,0,0,0,0,0
11/03/2020 11:02,202001,MIDDLE EAST,KUWAIT,HEATHROW,KUWAIT,40985,40985,0,38310,38310,0,6.982511
11/03/2020 11:02,202001,MIDDLE EAST,OMAN,HEATHROW,MUSCAT,34964,34964,0,34638,34638,0,0.941163
11/03/2020 11:02,202001,MIDDLE EAST,OMAN,MANCHESTER,MUSCAT,12796,12796,0,10957,10957,0,16.783791
11/03/2020 11:02,202001,MIDDLE EAST,QATAR,GATWICK,DOHA HAMAD,32296,32296,0,25292,25292,0,27.692551
11/03/2020 11:02,202001,MIDDLE EAST,QATAR,HEATHROW,DOHA HAMAD,117209,117209,0,104682,104682,0,11.966718
11/03/2020 11:02,202001,MIDDLE EAST,QATAR,BIRMINGHAM,DOHA HAMAD,11966,11966,0,11309,11309,0,5.809532
11/03/2020 11:02,202001,MIDDLE EAST,QATAR,CARDIFF WALES,DOHA HAMAD,8429,8429,0,6614,6614,0,27.44179
11/03/2020 11:02,202001,MIDDLE EAST,QATAR,EDINBURGH,DOHA HAMAD,13139,13139,0,12942,12942,0,1.522176
11/03/2020 11:02,202001,MIDDLE EAST,QATAR,MANCHESTER,DOHA HAMAD,43078,43078,0,36044,36044,0,19.515037
11/03/2020 11:02,202001,MIDDLE EAST,SAUDI ARABIA,HEATHROW,DAMMAM,2415,2415,0,0,0,0,0
11/03/2020 11:02,202001,MIDDLE EAST,SAUDI ARABIA,HEATHROW,JEDDAH,23478,23478,0,20243,20243,0,15.980833
11/03/2020 11:02,202001,MIDDLE EAST,SAUDI ARABIA,HEATHROW,RIYADH,26134,26134,0,21922,21922,0,19.213575
11/03/2020 11:02,202001,MIDDLE EAST,SAUDI ARABIA,MANCHESTER,JEDDAH,10600,10600,0,11121,11121,0,-4.684831
11/03/2020 11:02,202001,MIDDLE EAST,UNITED ARAB EMIRATES,GATWICK,DUBAI,80667,80667,0,79265,79265,0,1.76875
11/03/2020 11:02,202001,MIDDLE EAST,UNITED ARAB EMIRATES,HEATHROW,ABU DHABI INTERNATIONAL,99247,99247,0,87734,87734,0,13.122621
11/03/2020 11:02,202001,MIDDLE EAST,UNITED ARAB EMIRATES,HEATHROW,DUBAI,195600,195600,0,199194,199194,0,-1.804271
11/03/2020 11:02,202001,MIDDLE EAST,UNITED ARAB EMIRATES,STANSTED,DUBAI,36698,36698,0,17836,17836,0,105.752411
11/03/2020 11:02,202001,MIDDLE EAST,UNITED ARAB EMIRATES,BIRMINGHAM,ABU DHABI INTERNATIONAL,0,0,0,185,185,0,-100
11/03/2020 11:02,202001,MIDDLE EAST,UNITED ARAB EMIRATES,BIRMINGHAM,DUBAI,61169,61169,0,60154,60154,0,1.687336
11/03/2020 11:02,202001,MIDDLE EAST,UNITED ARAB EMIRATES,EDINBURGH,DUBAI,17412,17412,0,13443,13443,0,29.52466
11/03/2020 11:02,202001,MIDDLE EAST,UNITED ARAB EMIRATES,GLASGOW,DUBAI,37105,37105,0,36338,36338,0,2.110738
11/03/2020 11:02,202001,MIDDLE EAST,UNITED ARAB EMIRATES,LIVERPOOL (JOHN LENNON),DUBAI (WORLD CENTRAL),0,0,0,32,0,32,-100
11/03/2020 11:02,202001,MIDDLE EAST,UNITED ARAB EMIRATES,MANCHESTER,ABU DHABI INTERNATIONAL,36821,36821,0,32353,32353,0,13.810157
11/03/2020 11:02,202001,MIDDLE EAST,UNITED ARAB EMIRATES,MANCHESTER,DUBAI,86479,86479,0,84483,84483,0,2.362605
11/03/2020 11:02,202001,MIDDLE EAST,UNITED ARAB EMIRATES,MANCHESTER,DUBAI (WORLD CENTRAL),0,0,0,143,0,143,-100
11/03/2020 11:02,202001,MIDDLE EAST,UNITED ARAB EMIRATES,NEWCASTLE,DUBAI,21017,21017,0,20556,20556,0,2.242654
11/03/2020 11:02,202001,INDIAN SUB-CONTINENT,BANGLADESH,HEATHROW,DHAKHA,6622,6622,0,9199,9199,0,-28.013915
11/03/2020 11:02,202001,INDIAN SUB-CONTINENT,BANGLADESH,HEATHROW,SYLHET,4911,4911,0,7205,7205,0,-31.839001
11/03/2020 11:02,202001,INDIAN SUB-CONTINENT,BANGLADESH,MANCHESTER,DHAKHA,4762,4762,0,0,0,0,0
11/03/2020 11:02,202001,INDIAN SUB-CONTINENT,INDIA,GATWICK,GOA,5276,0,5276,10349,7993,2356,-49.019229
11/03/2020 11:02,202001,INDIAN SUB-CONTINENT,INDIA,HEATHROW,AHMEDABAD,8850,8850,0,8459,8459,0,4.622296
11/03/2020 11:02,202001,INDIAN SUB-CONTINENT,INDIA,HEATHROW,AMRITSAR,0,0,0,294,294,0,-100
11/03/2020 11:02,202001,INDIAN SUB-CONTINENT,INDIA,HEATHROW,BANGALORE (BENGALURU),24359,24359,0,21119,21119,0,15.341635
11/03/2020 11:02,202001,INDIAN SUB-CONTINENT,INDIA,HEATHROW,CHENNAI,12473,12473,0,12237,12237,0,1.928577
11/03/2020 11:02,202001,INDIAN SUB-CONTINENT,INDIA,HEATHROW,DELHI,74575,74575,0,90931,90931,0,-17.987265
11/03/2020 11:02,202001,INDIAN SUB-CONTINENT,INDIA,HEATHROW,HYDERABAD ( RAJIV GHANDI ),13034,13034,0,12505,12505,0,4.230308
11/03/2020 11:02,202001,INDIAN SUB-CONTINENT,INDIA,HEATHROW,MUMBAI,66409,66409,0,107100,107100,0,-37.993464
11/03/2020 11:02,202001,INDIAN SUB-CONTINENT,INDIA,STANSTED,AMRITSAR,5328,5328,0,0,0,0,0
11/03/2020 11:02,202001,INDIAN SUB-CONTINENT,INDIA,BIRMINGHAM,AMRITSAR,6302,6302,0,6300,6300,0,0.031746
11/03/2020 11:02,202001,INDIAN SUB-CONTINENT,INDIA,BIRMINGHAM,DELHI,6104,6104,0,5852,5852,0,4.30622
11/03/2020 11:02,202001,INDIAN SUB-CONTINENT,INDIA,BIRMINGHAM,GOA,0,0,0,2574,0,2574,-100
11/03/2020 11:02,202001,INDIAN SUB-CONTINENT,INDIA,MANCHESTER,GOA,4971,0,4971,12409,10096,2313,-59.940366
11/03/2020 11:02,202001,INDIAN SUB-CONTINENT,INDIA,MANCHESTER,MUMBAI,0,0,0,9837,9837,0,-100
11/03/2020 11:02,202001,INDIAN SUB-CONTINENT,PAKISTAN,GATWICK,BENAZIR BHUTTO INTERNATIONAL AIRPORT,0,0,0,69,0,69,-100
11/03/2020 11:02,202001,INDIAN SUB-CONTINENT,PAKISTAN,HEATHROW,BENAZIR BHUTTO INTERNATIONAL AIRPORT,0,0,0,12840,12840,0,-100
11/03/2020 11:02,202001,INDIAN SUB-CONTINENT,PAKISTAN,HEATHROW,ISLAMABAD INTERNATIONAL AIRPORT,17552,17552,0,0,0,0,0
11/03/2020 11:02,202001,INDIAN SUB-CONTINENT,PAKISTAN,HEATHROW,KARACHI,2506,2506,0,4659,4659,0,-46.211633
11/03/2020 11:02,202001,INDIAN SUB-CONTINENT,PAKISTAN,HEATHROW,LAHORE,9279,9279,0,8685,8685,0,6.839378
11/03/2020 11:02,202001,INDIAN SUB-CONTINENT,PAKISTAN,HEATHROW,SIALKOT,1701,1701,0,0,0,0,0
11/03/2020 11:02,202001,INDIAN SUB-CONTINENT,PAKISTAN,BIRMINGHAM,BENAZIR BHUTTO INTERNATIONAL AIRPORT,0,0,0,7720,7720,0,-100
11/03/2020 11:02,202001,INDIAN SUB-CONTINENT,PAKISTAN,BIRMINGHAM,ISLAMABAD INTERNATIONAL AIRPORT,10478,10478,0,0,0,0,0
11/03/2020 11:02,202001,INDIAN SUB-CONTINENT,PAKISTAN,DONCASTER SHEFFIELD,ISLAMABAD INTERNATIONAL AIRPORT,0,0,0,101,0,101,-100
11/03/2020 11:02,202001,INDIAN SUB-CONTINENT,PAKISTAN,MANCHESTER,BENAZIR BHUTTO INTERNATIONAL AIRPORT,0,0,0,17258,17258,0,-100
11/03/2020 11:02,202001,INDIAN SUB-CONTINENT,PAKISTAN,MANCHESTER,ISLAMABAD INTERNATIONAL AIRPORT,19014,19014,0,0,0,0,0
11/03/2020 11:02,202001,INDIAN SUB-CONTINENT,PAKISTAN,MANCHESTER,LAHORE,6061,6061,0,5055,5055,0,19.901088
11/03/2020 11:02,202001,INDIAN SUB-CONTINENT,SRI LANKA,GATWICK,COLOMBO,0,0,0,3439,0,3439,-100
11/03/2020 11:02,202001,INDIAN SUB-CONTINENT,SRI LANKA,HEATHROW,COLOMBO,24489,24489,0,22699,22699,0,7.88581
11/03/2020 11:02,202001,INDIAN SUB-CONTINENT,SRI LANKA,MANCHESTER,COLOMBO,0,0,0,334,0,334,-100
11/03/2020 11:02,202001,FAR EAST,BRUNEI,HEATHROW,BANDAR SERI BEGAWAN,11777,11777,0,10721,10721,0,9.849827
11/03/2020 11:02,202001,FAR EAST,CHINA,GATWICK,CHENGDU,0,0,0,4124,4124,0,-100
11/03/2020 11:02,202001,FAR EAST,CHINA,GATWICK,SHANGHAI (PU DONG),18343,18343,0,4780,4780,0,283.74477
11/03/2020 11:02,202001,FAR EAST,CHINA,HEATHROW,BEIJING,30679,30679,0,42779,42779,0,-28.284906
11/03/2020 11:02,202001,FAR EAST,CHINA,HEATHROW,BEIJING DAXING INTERNATIONAL AIRPORT,9564,9564,0,0,0,0,0
11/03/2020 11:02,202001,FAR EAST,CHINA,HEATHROW,CHANGSHA HUANGHUA INTERNATIONAL AIRPORT,3293,3293,0,3083,3083,0,6.811547
11/03/2020 11:02,202001,FAR EAST,CHINA,HEATHROW,CHENGDU,4997,4997,0,0,0,0,0
11/03/2020 11:02,202001,FAR EAST,CHINA,HEATHROW,CHONGQING JIANGBEI INTERNATIONAL,1649,1649,0,4616,4616,0,-64.27643
11/03/2020 11:02,202001,FAR EAST,CHINA,HEATHROW,GUANGZHOU BAIYUN INTERNATIONAL,14686,14686,0,13576,13576,0,8.176193
11/03/2020 11:02,202001,FAR EAST,CHINA,HEATHROW,QINGDAO,2742,2742,0,2075,2075,0,32.144578
11/03/2020 11:02,202001,FAR EAST,CHINA,HEATHROW,SANYA PHOENIX INTERNATIONAL,2254,2254,0,1058,1058,0,113.043478
11/03/2020 11:02,202001,FAR EAST,CHINA,HEATHROW,SHANGHAI (PU DONG),39079,39079,0,42218,42218,0,-7.435217
11/03/2020 11:02,202001,FAR EAST,CHINA,HEATHROW,SHENZHEN (HUANGTIAN),5343,5343,0,5074,5074,0,5.301537
11/03/2020 11:02,202001,FAR EAST,CHINA,HEATHROW,TIANJIN,940,940,0,1039,1039,0,-9.528393
11/03/2020 11:02,202001,FAR EAST,CHINA,HEATHROW,WUHAN TIANHE INTERNATIONAL,3999,3999,0,4510,4510,0,-11.330377
11/03/2020 11:02,202001,FAR EAST,CHINA,HEATHROW,XIAN XIANYANG,4140,4140,0,3842,3842,0,7.756377
11/03/2020 11:02,202001,FAR EAST,CHINA,HEATHROW,ZHENGZHOU XINZHENG,2792,2792,0,0,0,0,0
11/03/2020 11:02,202001,FAR EAST,CHINA,EDINBURGH,BEIJING,0,0,0,1666,1666,0,-100
11/03/2020 11:02,202001,FAR EAST,CHINA,MANCHESTER,BEIJING,5362,5362,0,6046,6046,0,-11.313265
11/03/2020 11:02,202001,FAR EAST,HONG KONG,GATWICK,HONG KONG (CHEK LAP KOK),14194,14194,0,14517,14517,0,-2.224978
11/03/2020 11:02,202001,FAR EAST,HONG KONG,HEATHROW,HONG KONG (CHEK LAP KOK),138564,138564,0,135598,135598,0,2.187348
11/03/2020 11:02,202001,FAR EAST,HONG KONG,MANCHESTER,HONG KONG (CHEK LAP KOK),18123,18123,0,16620,16620,0,9.043321
11/03/2020 11:02,202001,FAR EAST,INDONESIA,HEATHROW,BALI INTERNATIONAL,845,845,0,353,353,0,139.376771
11/03/2020 11:02,202001,FAR EAST,INDONESIA,HEATHROW,JAKARTA (SOEKARNO-HATTA INTNL),0,0,0,3162,3162,0,-100
11/03/2020 11:02,202001,FAR EAST,INDONESIA,HEATHROW,KUALANAMU INTERNATIONAL AIRPORT,2995,2995,0,0,0,0,0
11/03/2020 11:02,202001,FAR EAST,JAPAN,HEATHROW,OSAKA (KANSAI),4207,4207,0,0,0,0,0
11/03/2020 11:02,202001,FAR EAST,JAPAN,HEATHROW,TOKYO (HANEDA),44866,44866,0,42631,42631,0,5.242664
11/03/2020 11:02,202001,FAR EAST,JAPAN,HEATHROW,TOKYO (NARITA),10370,10370,0,10059,10059,0,3.091759
11/03/2020 11:02,202001,FAR EAST,MALAYSIA,GATWICK,LANGKAWI,1649,0,1649,1748,0,1748,-5.663616
11/03/2020 11:02,202001,FAR EAST,MALAYSIA,HEATHROW,KUALA LUMPUR (SEPANG),40227,40227,0,41187,41187,0,-2.330833
11/03/2020 11:02,202001,FAR EAST,MALAYSIA,BIRMINGHAM,LANGKAWI,1641,0,1641,1771,0,1771,-7.340486
11/03/2020 11:02,202001,FAR EAST,MALAYSIA,MANCHESTER,LANGKAWI,1720,0,1720,1469,0,1469,17.086453
11/03/2020 11:02,202001,FAR EAST,PHILIPPINES,HEATHROW,MANILA,9823,9823,0,11339,11339,0,-13.369786
11/03/2020 11:02,202001,FAR EAST,REPUBLIC OF KOREA,HEATHROW,SEOUL (INCHEON),39215,39215,0,44816,44816,0,-12.497769
11/03/2020 11:02,202001,FAR EAST,SINGAPORE,GATWICK,SINGAPORE,0,0,0,4228,4228,0,-100
11/03/2020 11:02,202001,FAR EAST,SINGAPORE,HEATHROW,SINGAPORE,127276,127276,0,126274,126274,0,0.793513
11/03/2020 11:02,202001,FAR EAST,SINGAPORE,MANCHESTER,SINGAPORE,8406,8406,0,7868,7868,0,6.837824
11/03/2020 11:02,202001,FAR EAST,TAIWAN,GATWICK,TAIPEI,9803,9803,0,8386,8386,0,16.89721
11/03/2020 11:02,202001,FAR EAST,TAIWAN,HEATHROW,TAIPEI,2392,2392,0,2330,2330,0,2.660944
11/03/2020 11:02,202001,FAR EAST,THAILAND,GATWICK,PHUKET,2683,0,2683,2363,0,2363,13.542107
11/03/2020 11:02,202001,FAR EAST,THAILAND,GATWICK,U-TAPAO,1099,0,1099,1126,0,1126,-2.397869
11/03/2020 11:02,202001,FAR EAST,THAILAND,HEATHROW,BANGKOK SUVARNABHUMI ,80763,80763,0,75323,75323,0,7.22223
11/03/2020 11:02,202001,FAR EAST,THAILAND,BIRMINGHAM,U-TAPAO,1146,0,1146,1190,0,1190,-3.697479
11/03/2020 11:02,202001,FAR EAST,THAILAND,MANCHESTER,PHUKET,2896,0,2896,2823,0,2823,2.585902
11/03/2020 11:02,202001,FAR EAST,THAILAND,MANCHESTER,U-TAPAO,1158,0,1158,1155,0,1155,0.25974
11/03/2020 11:02,202001,FAR EAST,VIETNAM,GATWICK,PHU QUOC INTERNATIONAL,2374,0,2374,2578,0,2578,-7.913111
11/03/2020 11:02,202001,FAR EAST,VIETNAM,HEATHROW,HANOI,8699,8699,0,8167,8167,0,6.51402
11/03/2020 11:02,202001,FAR EAST,VIETNAM,HEATHROW,HO CHI MINH CITY,6393,6393,0,6068,6068,0,5.355966
11/03/2020 11:02,202001,AUSTRALASIA,AUSTRALIA,HEATHROW,MELBOURNE,1216,1216,0,1316,1316,0,-7.598784
11/03/2020 11:02,202001,AUSTRALASIA,AUSTRALIA,HEATHROW,PERTH (AUSTRALIA),11573,11573,0,11721,11721,0,-1.262691
11/03/2020 11:02,202001,AUSTRALASIA,AUSTRALIA,HEATHROW,SYDNEY,16239,16239,0,17539,17539,0,-7.412053
11/03/2020 11:02,202001,AUSTRALASIA,NEW ZEALAND,HEATHROW,AUCKLAND INTERNATIONAL,2072,2072,0,1832,1832,0,13.100437
11/03/2020 11:02,202001,CANADA,CANADA,GATWICK,CALGARY,8563,8563,0,6075,6075,0,40.954733
11/03/2020 11:02,202001,CANADA,CANADA,GATWICK,TORONTO,29158,29158,0,26143,26143,0,11.532724
11/03/2020 11:02,202001,CANADA,CANADA,HEATHROW,CALGARY,14824,14824,0,15561,15561,0,-4.736199
11/03/2020 11:02,202001,CANADA,CANADA,HEATHROW,HALIFAX INT,0,0,0,4362,4362,0,-100
11/03/2020 11:02,202001,CANADA,CANADA,HEATHROW,MONTREAL (DORVAL),24855,24855,0,24127,24127,0,3.017366
11/03/2020 11:02,202001,CANADA,CANADA,HEATHROW,OTTAWA INTERNATIONAL,7650,7650,0,8132,8132,0,-5.927201
11/03/2020 11:02,202001,CANADA,CANADA,HEATHROW,ST JOHNS,0,0,0,1448,1448,0,-100
11/03/2020 11:02,202001,CANADA,CANADA,HEATHROW,TORONTO,82622,82622,0,82361,82361,0,0.316898
11/03/2020 11:02,202001,CANADA,CANADA,HEATHROW,VANCOUVER,38122,38122,0,37023,37023,0,2.968425
11/03/2020 11:02,202001,CANADA,CANADA,GLASGOW,TORONTO,3085,3085,0,2514,2514,0,22.712808
11/03/2020 11:02,202001,CANADA,CANADA,MANCHESTER,TORONTO,4483,4483,0,3822,3822,0,17.29461
11/03/2020 11:02,202001,UNITED STATES OF AMERICA,USA,GATWICK,BOSTON,14029,14029,0,16135,16135,0,-13.052371
11/03/2020 11:02,202001,UNITED STATES OF AMERICA,USA,GATWICK,CHICAGO (O'HARE),0,0,0,9726,9726,0,-100
11/03/2020 11:02,202001,UNITED STATES OF AMERICA,USA,GATWICK,DENVER INTERNATIONAL,0,0,0,6629,6629,0,-100
11/03/2020 11:02,202001,UNITED STATES OF AMERICA,USA,GATWICK,FORT LAUDERDALE,0,0,0,21193,21193,0,-100
11/03/2020 11:02,202001,UNITED STATES OF AMERICA,USA,GATWICK,LAS VEGAS,6213,6213,0,26884,26884,0,-76.8896
11/03/2020 11:02,202001,UNITED STATES OF AMERICA,USA,GATWICK,LOS ANGELES INTERNATIONAL,17756,17756,0,17671,17671,0,0.481014
11/03/2020 11:02,202001,UNITED STATES OF AMERICA,USA,GATWICK,MIAMI INTERNATIONAL,13954,13954,0,0,0,0,0
11/03/2020 11:02,202001,UNITED STATES OF AMERICA,USA,GATWICK,NEW YORK (JF KENNEDY),45857,45857,0,46849,46849,0,-2.117441
11/03/2020 11:02,202001,UNITED STATES OF AMERICA,USA,GATWICK,OAKLAND,0,0,0,7725,7725,0,-100
11/03/2020 11:02,202001,UNITED STATES OF AMERICA,USA,GATWICK,ORLANDO,52394,52394,0,48884,48884,0,7.180263
11/03/2020 11:02,202001,UNITED STATES OF AMERICA,USA,GATWICK,SAN FRANCISCO,9841,9841,0,0,0,0,0
11/03/2020 11:02,202001,UNITED STATES OF AMERICA,USA,GATWICK,TAMPA,16950,16950,0,14370,14370,0,17.954071
11/03/2020 11:02,202001,UNITED STATES OF AMERICA,USA,GATWICK,TETERBORO,0,0,0,1,0,1,-100
11/03/2020 11:02,202001,UNITED STATES OF AMERICA,USA,HEATHROW,ATLANTA,44567,44567,0,47113,47113,0,-5.404029
11/03/2020 11:02,202001,UNITED STATES OF AMERICA,USA,HEATHROW,AUSTIN (BERGSTROM),13478,13478,0,12802,12802,0,5.280425
11/03/2020 11:02,202001,UNITED STATES OF AMERICA,USA,HEATHROW,BALTIMORE,12029,12029,0,9519,9519,0,26.368316
11/03/2020 11:02,202001,UNITED STATES OF AMERICA,USA,HEATHROW,BOSTON,65992,65992,0,54834,54834,0,20.348689
11/03/2020 11:02,202001,UNITED STATES OF AMERICA,USA,HEATHROW,CHARLOTTE,24822,24822,0,20737,20737,0,19.699089
11/03/2020 11:02,202001,UNITED STATES OF AMERICA,USA,HEATHROW,CHICAGO (O'HARE),72074,72074,0,71605,71605,0,0.654982
11/03/2020 11:02,202001,UNITED STATES OF AMERICA,USA,HEATHROW,DALLAS/FORT WORTH,58469,58469,0,60932,60932,0,-4.042211
11/03/2020 11:02,202001,UNITED STATES OF AMERICA,USA,HEATHROW,DENVER INTERNATIONAL,23292,23292,0,15444,15444,0,50.815851
11/03/2020 11:02,202001,UNITED STATES OF AMERICA,USA,HEATHROW,DETROIT,9832,9832,0,13764,13764,0,-28.567277
11/03/2020 11:02,202001,UNITED STATES OF AMERICA,USA,HEATHROW,HOUSTON,35383,35383,0,37840,37840,0,-6.493129
11/03/2020 11:02,202001,UNITED STATES OF AMERICA,USA,HEATHROW,LAS VEGAS,31995,31995,0,20104,20104,0,59.147433
11/03/2020 11:02,202001,UNITED STATES OF AMERICA,USA,HEATHROW,LOS ANGELES INTERNATIONAL,128984,128984,0,120088,120088,0,7.407901
11/03/2020 11:02,202001,UNITED STATES OF AMERICA,USA,HEATHROW,MIAMI INTERNATIONAL,91068,91068,0,96285,96285,0,-5.418289
11/03/2020 11:02,202001,UNITED STATES OF AMERICA,USA,HEATHROW,MINNEAPOLIS-ST PAUL,8988,8988,0,8932,8932,0,0.626959
11/03/2020 11:02,202001,UNITED STATES OF AMERICA,USA,HEATHROW,NASHVILLE METROPOLITAN,6090,6090,0,4659,4659,0,30.714746
11/03/2020 11:02,202001,UNITED STATES OF AMERICA,USA,HEATHROW,NEW ORLEANS,7234,7234,0,6320,6320,0,14.462025
11/03/2020 11:02,202001,UNITED STATES OF AMERICA,USA,HEATHROW,NEW YORK (JF KENNEDY),225755,225755,0,209181,208899,282,7.923282
11/03/2020 11:02,202001,UNITED STATES OF AMERICA,USA,HEATHROW,NEW YORK (NEWARK),66921,66921,0,69474,69474,0,-3.674756
11/03/2020 11:02,202001,UNITED STATES OF AMERICA,USA,HEATHROW,ORLANDO,0,0,0,13,13,0,-100
11/03/2020 11:02,202001,UNITED STATES OF AMERICA,USA,HEATHROW,PHILADELPHIA INTERNATIONAL,29995,29995,0,32885,32885,0,-8.788201
11/03/2020 11:02,202001,UNITED STATES OF AMERICA,USA,HEATHROW,PHOENIX,23008,23008,0,16955,16955,0,35.700383
11/03/2020 11:02,202001,UNITED STATES OF AMERICA,USA,HEATHROW,PITTSBURGH,4836,4836,0,0,0,0,0
11/03/2020 11:02,202001,UNITED STATES OF AMERICA,USA,HEATHROW,RALEIGH,10079,10079,0,10604,10604,0,-4.950962
11/03/2020 11:02,202001,UNITED STATES OF AMERICA,USA,HEATHROW,SALT LAKE CITY,7735,7735,0,0,0,0,0
11/03/2020 11:02,202001,UNITED STATES OF AMERICA,USA,HEATHROW,SAN DIEGO,14748,14748,0,13073,13073,0,12.812667
11/03/2020 11:02,202001,UNITED STATES OF AMERICA,USA,HEATHROW,SAN FRANCISCO,72367,72367,0,75006,75006,0,-3.518385
11/03/2020 11:02,202001,UNITED STATES OF AMERICA,USA,HEATHROW,SAN JOSE,8855,8855,0,8777,8777,0,0.888686
11/03/2020 11:02,202001,UNITED STATES OF AMERICA,USA,HEATHROW,SEATTLE (TACOMA),28247,28247,0,26500,26500,0,6.592453
11/03/2020 11:02,202001,UNITED STATES OF AMERICA,USA,HEATHROW,WASHINGTON (DULLES),59158,59158,0,57192,56812,380,3.437544
11/03/2020 11:02,202001,UNITED STATES OF AMERICA,USA,LONDON CITY,NEW YORK (JF KENNEDY),845,845,0,699,699,0,20.886981
11/03/2020 11:02,202001,UNITED STATES OF AMERICA,USA,EDINBURGH,NEW YORK (JF KENNEDY),4490,4490,0,1147,1147,0,291.455972
11/03/2020 11:02,202001,UNITED STATES OF AMERICA,USA,EDINBURGH,NEW YORK (NEWARK),8701,8701,0,8971,8971,0,-3.009698
11/03/2020 11:02,202001,UNITED STATES OF AMERICA,USA,EDINBURGH,NEWBURGH/USA,0,0,0,5240,5240,0,-100
11/03/2020 11:02,202001,UNITED STATES OF AMERICA,USA,GLASGOW,ORLANDO,262,262,0,0,0,0,0
11/03/2020 11:02,202001,UNITED STATES OF AMERICA,USA,LEEDS BRADFORD,NEW YORK (NEWARK),220,220,0,221,221,0,-0.452489
11/03/2020 11:02,202001,UNITED STATES OF AMERICA,USA,MANCHESTER,ATLANTA,6214,6214,0,7995,7995,0,-22.276423
11/03/2020 11:02,202001,UNITED STATES OF AMERICA,USA,MANCHESTER,HOUSTON,5018,5018,0,4980,4980,0,0.763052
11/03/2020 11:02,202001,UNITED STATES OF AMERICA,USA,MANCHESTER,NEW YORK (JF KENNEDY),13950,13950,0,17421,17421,0,-19.924229
11/03/2020 11:02,202001,UNITED STATES OF AMERICA,USA,MANCHESTER,NEW YORK (NEWARK),11089,11089,0,9472,9472,0,17.071368
11/03/2020 11:02,202001,UNITED STATES OF AMERICA,USA,MANCHESTER,ORLANDO,17847,17847,0,19601,19601,0,-8.948523
11/03/2020 11:02,202001,UNITED STATES OF AMERICA,USA,MANCHESTER,PHILADELPHIA INTERNATIONAL,9048,9048,0,9505,9505,0,-4.807996
11/03/2020 11:02,202001,UNITED STATES OF AMERICA,USA,NEWCASTLE,NEW YORK (NEWARK),0,0,0,221,221,0,-100
11/03/2020 11:02,202001,UNITED STATES OF AMERICA,USA,PRESTWICK,NEW YORK (JF KENNEDY),0,0,0,127,0,127,-100
11/03/2020 11:02,202001,CENTRAL AMERICA,COSTA RICA,GATWICK,LIBERIA,2458,0,2458,2680,0,2680,-8.283582
11/03/2020 11:02,202001,CENTRAL AMERICA,COSTA RICA,GATWICK,SAN JOSE COST RICA,7467,7467,0,6797,6797,0,9.85729
11/03/2020 11:02,202001,CENTRAL AMERICA,CUBA,GATWICK,HAVANA,4191,4191,0,7027,7027,0,-40.358617
11/03/2020 11:02,202001,CENTRAL AMERICA,CUBA,GATWICK,HOLGUIN (FRANK PAIS),0,0,0,3094,3094,0,-100
11/03/2020 11:02,202001,CENTRAL AMERICA,CUBA,MANCHESTER,CUNAGUA (CAYO COCO),0,0,0,3059,3059,0,-100
11/03/2020 11:02,202001,CENTRAL AMERICA,CUBA,MANCHESTER,HOLGUIN (FRANK PAIS),0,0,0,2832,2832,0,-100
11/03/2020 11:02,202001,CENTRAL AMERICA,CUBA,MANCHESTER,VARADERO,0,0,0,2505,2505,0,-100
11/03/2020 11:02,202001,CENTRAL AMERICA,DOMINICAN REPUBLIC,GATWICK,PUNTA CANA,19111,11781,7330,13228,7803,5425,44.473843
11/03/2020 11:02,202001,CENTRAL AMERICA,DOMINICAN REPUBLIC,MANCHESTER,LA ROMANA,868,0,868,0,0,0,0
11/03/2020 11:02,202001,CENTRAL AMERICA,DOMINICAN REPUBLIC,MANCHESTER,PUNTA CANA,6138,0,6138,6138,0,6138,0
11/03/2020 11:02,202001,CENTRAL AMERICA,MEXICO,GATWICK,CANCUN,22862,22862,0,24016,22398,1618,-4.80513
11/03/2020 11:02,202001,CENTRAL AMERICA,MEXICO,GATWICK,LOS CABOS,2237,0,2237,0,0,0,0
11/03/2020 11:02,202001,CENTRAL AMERICA,MEXICO,GATWICK,PUERTO VALLARTA,0,0,0,2393,0,2393,-100
11/03/2020 11:02,202001,CENTRAL AMERICA,MEXICO,HEATHROW,MEXICO CITY,19534,19534,0,19897,19897,0,-1.824396
11/03/2020 11:02,202001,CENTRAL AMERICA,MEXICO,BIRMINGHAM,CANCUN,5731,5731,0,5973,5973,0,-4.051565
11/03/2020 11:02,202001,CENTRAL AMERICA,MEXICO,MANCHESTER,CANCUN,7729,7729,0,13449,13449,0,-42.531043
11/03/2020 11:02,202001,CENTRAL AMERICA,MEXICO,MANCHESTER,PUERTO VALLARTA,6142,0,6142,2742,0,2742,123.997082
11/03/2020 11:02,202001,SOUTH AMERICA,ARGENTINA,GATWICK,BUENOS AIRES,15042,15042,0,14227,14227,0,5.728544
11/03/2020 11:02,202001,SOUTH AMERICA,ARGENTINA,HEATHROW,BUENOS AIRES,15042,15042,0,15193,15193,0,-0.993879
11/03/2020 11:02,202001,SOUTH AMERICA,BRAZIL,GATWICK,MANAUS-EDUARDO GOMES,0,0,0,304,0,304,-100
11/03/2020 11:02,202001,SOUTH AMERICA,BRAZIL,GATWICK,RIO DE JANEIRO (GALEAO),9195,9195,0,0,0,0,0
11/03/2020 11:02,202001,SOUTH AMERICA,BRAZIL,HEATHROW,RIO DE JANEIRO (GALEAO),11722,11722,0,11483,11483,0,2.081338
11/03/2020 11:02,202001,SOUTH AMERICA,BRAZIL,HEATHROW,SAO PAULO (GUARULHOS),38564,38564,0,40859,40859,0,-5.616878
11/03/2020 11:02,202001,SOUTH AMERICA,BRAZIL,MANCHESTER,MANAUS-EDUARDO GOMES,0,0,0,307,307,0,-100
11/03/2020 11:02,202001,SOUTH AMERICA,CHILE,HEATHROW,SANTIAGO DE CHILE,8182,8182,0,8547,8547,0,-4.270504
11/03/2020 11:02,202001,SOUTH AMERICA,COLOMBIA,HEATHROW,BOGOTA,14156,14156,0,14251,14251,0,-0.66662
11/03/2020 11:02,202001,CARIBBEAN AREA,ANTIGUA AND BARBUDA,GATWICK,ANTIGUA,19814,19814,0,17125,17125,0,15.70219
11/03/2020 11:02,202001,CARIBBEAN AREA,ANTIGUA AND BARBUDA,MANCHESTER,ANTIGUA,0,0,0,1485,1485,0,-100
11/03/2020 11:02,202001,CARIBBEAN AREA,BAHAMAS,HEATHROW,NASSAU,4788,4788,0,5237,5237,0,-8.573611
11/03/2020 11:02,202001,CARIBBEAN AREA,BARBADOS,GATWICK,BRIDGETOWN,59993,40815,19178,62201,41970,20231,-3.549782
11/03/2020 11:02,202001,CARIBBEAN AREA,BARBADOS,HEATHROW,BRIDGETOWN,1556,1556,0,3398,3398,0,-54.208358
11/03/2020 11:02,202001,CARIBBEAN AREA,BARBADOS,BELFAST INTERNATIONAL,BRIDGETOWN,0,0,0,288,0,288,-100
11/03/2020 11:02,202001,CARIBBEAN AREA,BARBADOS,BIRMINGHAM,BRIDGETOWN,11228,0,11228,9680,0,9680,15.991736
11/03/2020 11:02,202001,CARIBBEAN AREA,BARBADOS,BOURNEMOUTH,BRIDGETOWN,949,0,949,882,0,882,7.596372
11/03/2020 11:02,202001,CARIBBEAN AREA,BARBADOS,BRISTOL,BRIDGETOWN,0,0,0,291,0,291,-100
11/03/2020 11:02,202001,CARIBBEAN AREA,BARBADOS,CARDIFF WALES,BRIDGETOWN,339,0,339,596,0,596,-43.120805
11/03/2020 11:02,202001,CARIBBEAN AREA,BARBADOS,DONCASTER SHEFFIELD,BRIDGETOWN,611,0,611,622,0,622,-1.768489
11/03/2020 11:02,202001,CARIBBEAN AREA,BARBADOS,GLASGOW,BRIDGETOWN,964,0,964,1192,0,1192,-19.127517
11/03/2020 11:02,202001,CARIBBEAN AREA,BARBADOS,MANCHESTER,BRIDGETOWN,19726,7176,12550,23874,9827,14047,-17.37455
11/03/2020 11:02,202001,CARIBBEAN AREA,BARBADOS,NEWCASTLE,BRIDGETOWN,625,625,0,582,582,0,7.388316
11/03/2020 11:02,202001,CARIBBEAN AREA,BERMUDA,GATWICK,BERMUDA,6413,6413,0,5575,5575,0,15.03139
11/03/2020 11:02,202001,CARIBBEAN AREA,CAYMAN ISLANDS,HEATHROW,GRAND CAYMAN,3473,3473,0,2884,2884,0,20.423024
11/03/2020 11:02,202001,CARIBBEAN AREA,GRENADA,GATWICK,GRENADA,4922,4922,0,3823,3823,0,28.747057
11/03/2020 11:02,202001,CARIBBEAN AREA,JAMAICA,GATWICK,KINGSTON,8471,8471,0,8631,8631,0,-1.853783
11/03/2020 11:02,202001,CARIBBEAN AREA,JAMAICA,GATWICK,MONTEGO BAY,19543,10069,9474,19576,9783,9793,-0.168574
11/03/2020 11:02,202001,CARIBBEAN AREA,JAMAICA,STANSTED,MONTEGO BAY,0,0,0,600,0,600,-100
11/03/2020 11:02,202001,CARIBBEAN AREA,JAMAICA,BIRMINGHAM,MONTEGO BAY,3071,0,3071,2974,0,2974,3.261601
11/03/2020 11:02,202001,CARIBBEAN AREA,JAMAICA,CARDIFF WALES,MONTEGO BAY,588,0,588,593,0,593,-0.84317
11/03/2020 11:02,202001,CARIBBEAN AREA,JAMAICA,GLASGOW,MONTEGO BAY,297,0,297,923,0,923,-67.822319
11/03/2020 11:02,202001,CARIBBEAN AREA,JAMAICA,MANCHESTER,MONTEGO BAY,9739,0,9739,9514,0,9514,2.364936
11/03/2020 11:02,202001,CARIBBEAN AREA,JAMAICA,NEWCASTLE,MONTEGO BAY,599,599,0,299,299,0,100.334448
11/03/2020 11:02,202001,CARIBBEAN AREA,SAINT KITTS AND NEVIS,GATWICK,ST KITTS,1678,1678,0,1515,1515,0,10.759076
11/03/2020 11:02,202001,CARIBBEAN AREA,ST LUCIA,GATWICK,ST LUCIA (HEWANORRA),17470,16307,1163,18963,14861,4102,-7.873227
11/03/2020 11:02,202001,CARIBBEAN AREA,ST LUCIA,MANCHESTER,ST LUCIA (HEWANORRA),0,0,0,1103,1103,0,-100
11/03/2020 11:02,202001,CARIBBEAN AREA,TRINIDAD AND TOBAGO,GATWICK,PORT OF SPAIN,5371,5371,0,4931,4931,0,8.923139
11/03/2020 11:02,202001,CARIBBEAN AREA,TRINIDAD AND TOBAGO,GATWICK,TOBAGO,3358,3358,0,3408,3408,0,-1.467136
11/03/2020 11:02,202001,CARIBBEAN AREA,TRINIDAD AND TOBAGO,MANCHESTER,TOBAGO,0,0,0,1181,1181,0,-100
11/03/2020 11:02,202001,CARIBBEAN AREA,TURKS AND CAICOS ISLANDS,GATWICK,PROVIDENCIALES,798,798,0,1117,1117,0,-28.558639
11/03/2020 11:02,202001,INDIAN OCEAN ISLANDS,MALDIVE ISLANDS,GATWICK,MALE INTERNATIONAL,7515,7515,0,6069,6069,0,23.826001
11/03/2020 11:02,202001,INDIAN OCEAN ISLANDS,MAURITIUS,GATWICK,MAURITIUS,12809,12809,0,11686,11686,0,9.609789
11/03/2020 11:02,202001,INDIAN OCEAN ISLANDS,MAURITIUS,HEATHROW,MAURITIUS,6736,6736,0,6035,6035,0,11.615576
11/03/2020 11:02,202001,INDIAN OCEAN ISLANDS,SEYCHELLES,HEATHROW,SEYCHELLES,2343,2343,0,3188,3188,0,-26.505646
11/03/2020 11:02,202001,ATLANTIC OCEAN ISLANDS,CAPE VERDE ISLANDS,GATWICK,BOA VISTA (RABIL),7671,7671,0,7320,7320,0,4.795082
11/03/2020 11:02,202001,ATLANTIC OCEAN ISLANDS,CAPE VERDE ISLANDS,GATWICK,ILHA DO SAL C.VERDE,5682,5682,0,8808,8808,0,-35.490463
11/03/2020 11:02,202001,ATLANTIC OCEAN ISLANDS,CAPE VERDE ISLANDS,BIRMINGHAM,BOA VISTA (RABIL),3765,3765,0,3717,3717,0,1.291364
11/03/2020 11:02,202001,ATLANTIC OCEAN ISLANDS,CAPE VERDE ISLANDS,BIRMINGHAM,ILHA DO SAL C.VERDE,3493,3493,0,2221,2221,0,57.271499
11/03/2020 11:02,202001,ATLANTIC OCEAN ISLANDS,CAPE VERDE ISLANDS,BRISTOL,ILHA DO SAL C.VERDE,1394,0,1394,1991,1022,969,-29.984932
11/03/2020 11:02,202001,ATLANTIC OCEAN ISLANDS,CAPE VERDE ISLANDS,MANCHESTER,BOA VISTA (RABIL),5574,5574,0,5508,5508,0,1.198257
11/03/2020 11:02,202001,ATLANTIC OCEAN ISLANDS,CAPE VERDE ISLANDS,MANCHESTER,ILHA DO SAL C.VERDE,5550,5550,0,7202,7202,0,-22.938073
11/03/2020 11:02,202001,OIL RIGS,OIL RIGS,ABERDEEN,OIL RIGS,31151,0,31151,34114,0,34114,-8.685584
11/03/2020 11:02,202001,OIL RIGS,OIL RIGS,BLACKPOOL,OIL RIGS,1546,0,1546,1297,0,1297,19.19815
11/03/2020 11:02,202001,OIL RIGS,OIL RIGS,HUMBERSIDE,OIL RIGS,841,0,841,1596,0,1596,-47.305764
11/03/2020 11:02,202001,OIL RIGS,OIL RIGS,INVERNESS,OIL RIGS,19,0,19,0,0,0,0
11/03/2020 11:02,202001,OIL RIGS,OIL RIGS,NORWICH,OIL RIGS,6862,0,6862,6717,0,6717,2.158702
11/03/2020 11:02,202001,OIL RIGS,OIL RIGS,SCATSTA,OIL RIGS,3983,0,3983,4446,0,4446,-10.413855
11/03/2020 11:02,202001,OIL RIGS,OIL RIGS,SUMBURGH,OIL RIGS,3133,0,3133,5281,0,5281,-40.674115

